Hours Studied,Previous Scores,Extracurricular Activities,Sleep Hours,Sample Question Papers Practiced,Total effort hours,Performance Index
7,99,Yes,9,1,8,91
4,82,No,4,2,6,65
8,51,Yes,7,2,10,45
5,52,Yes,5,2,7,36
7,75,No,8,5,12,66
3,78,No,9,6,9,61
7,73,Yes,5,6,13,63
8,45,Yes,4,6,14,42
5,77,No,8,2,7,61
4,89,No,4,0,4,69
8,91,No,4,5,13,84
8,79,No,6,2,10,73
3,47,No,9,2,5,27
6,47,N,4,2,8,33
5,79,No,7,8,13,68
2,72,No,4,3,5,43
8,73,Yes,8,4,12,67
6,83,Yes,7,2,8,70
2,54,Yes,4,9,11,30
5,75,No,7,0,5,63
1,99,Y,4,3,4,71
6,96,No,9,0,6,85
9,74,Yes,7,6,15,73
1,85,No,5,6,7,57
3,61,No,6,3,6,35
7,62,Yes,7,4,11,49
4,79,No,8,9,13,66
9,84,Yes,6,6,15,83
3,94,Yes,6,5,8,74
5,90,Yes,4,3,8,74
3,61,Yes,7,3,6,39
7,44,Yes,9,1,8,36
5,70,Yes,6,9,14,58
9,52,Yes,8,1,10,47
7,67,Yes,9,3,10,60
2,97,Y,9,4,6,74
4,59,No,8,3,7,42
9,72,No,8,2,11,68
2,55,Yes,4,1,3,32
9,68,No,5,3,12,64
5,62,No,7,4,9,45
2,63,Yes,6,0,2,39
4,73,Yes,7,0,4,58
7,46,N,9,5,12,36
8,77,Yes,6,4,12,71
3,76,Yes,4,3,6,54
1,43,Yes,7,0,1,17
4,73,No,4,6,10,54
2,81,Yes,4,3,5,58
8,61,No,7,2,10,53
4,44,Yes,7,6,10,27
2,89,Yes,6,1,3,65
6,81,No,9,9,15,75
6,62,Yes,9,0,6,52
4,93,No,8,3,7,78
6,99,No,4,7,13,91
2,54,Yes,9,5,7,33
2,70,Yes,5,8,10,47
4,98,No,6,0,4,78
8,48,N,6,0,8,38
7,82,Yes,8,4,11,70
9,97,Yes,8,5,14,98
8,92,Yes,4,7,15,87
5,64,Y,6,2,7,49
2,64,Yes,6,5,7,41
5,88,No,5,2,7,71
8,60,No,4,7,15,54
9,48,No,4,3,12,42
9,94,No,9,1,10,91
1,87,Yes,8,8,9,61
9,77,No,9,9,18,74
7,61,Yes,4,7,14,54
9,82,Yes,5,5,14,81
8,62,Yes,4,2,10,52
1,88,Yes,9,1,2,65
8,43,Yes,7,3,11,36
8,68,No,7,3,11,61
3,54,Yes,5,0,3,35
1,40,Yes,8,8,9,15
8,93,Yes,6,9,17,88
3,69,No,4,7,10,45
3,68,Yes,9,6,9,49
1,59,Yes,8,5,6,33
5,72,Yes,9,2,7,60
7,80,No,8,3,10,71
9,83,Yes,4,1,10,81
7,75,No,6,6,13,67
9,99,No,4,1,10,95
8,61,Yes,6,9,17,58
2,52,No,9,0,2,29
1,46,No,5,5,6,21
7,47,Yes,6,3,10,38
7,67,Yes,8,7,14,60
8,84,Yes,5,0,8,76
5,82,Yes,9,8,13,69
3,48,No,7,5,8,30
8,64,No,5,1,9,57
6,95,Yes,6,7,13,81
3,55,Yes,5,4,7,36
1,49,Yes,9,4,5,25
3,50,No,5,4,7,27
5,70,Yes,9,6,11,61
3,51,No,7,6,9,34
1,99,No,6,9,10,76
5,70,N,8,6,11,57
7,53,No,5,9,16,45
7,90,Yes,4,1,8,76
9,83,Yes,8,7,16,83
3,71,Yes,5,0,3,50
7,89,No,8,1,8,81
1,92,No,4,6,7,66
4,56,Yes,8,3,7,38
4,74,No,8,9,13,56
5,40,No,4,9,14,25
7,68,No,4,8,15,56
7,90,Yes,4,8,15,82
4,43,Yes,7,2,6,23
7,62,Yes,9,2,9,56
3,67,Nah,9,8,11,46
6,55,Yes,4,9,15,43
2,51,Yes,9,7,9,30
9,92,Yes,8,0,9,92
5,60,No,4,5,10,45
6,84,No,5,6,12,70
4,56,No,4,7,11,36
7,79,No,4,1,8,71
9,52,No,9,0,9,49
7,91,Yes,6,3,10,82
1,97,Yess,8,0,1,71
1,71,No,9,1,2,43
9,76,No,8,2,11,77
9,89,Yes,5,3,12,86
4,54,No,7,5,9,34
9,51,No,6,7,16,49
3,88,No,5,8,11,69
7,96,N,5,3,10,84
6,54,No,8,0,6,41
8,73,Yes,6,4,12,68
9,45,Yes,8,4,13,44
5,56,No,7,8,13,41
1,87,No,8,5,6,58
3,88,Yes,4,4,7,68
8,96,No,8,9,17,94
6,59,Yes,4,9,15,47
8,48,No,5,4,12,40
9,98,Yes,7,7,16,200
4,44,Yes,9,0,4,23
1,62,No,4,4,5,36
1,72,No,7,0,1,47
4,77,Yes,8,6,10,60
7,95,No,9,6,13,83
2,53,Yes,8,9,11,33
3,56,No,5,7,10,36
1,96,No,8,6,7,74
5,58,No,4,8,13,42
1,72,Yes,5,7,8,47
8,40,Yes,7,7,15,31
1,52,No,5,2,3,26
1,85,Yes,7,9,10,58
2,66,No,6,3,5,42
2,45,Yes,4,3,5,18
6,98,No,4,0,6,85
7,45,Yes,7,5,12,36
5,72,Yes,8,1,6,58
1,69,Yes,9,8,9,45
1,85,Yes,8,0,1,60
3,74,Yes,6,0,3,56
2,62,Yes,7,9,11,42
5,49,No,6,5,10,33
6,90,No,7,0,6,77
7,58,Y,6,2,9,51
4,90,No,7,9,13,72
7,67,Yes,4,1,8,57
8,62,No,6,8,16,53
1,43,No,6,4,5,16
6,59,No,7,5,11,45
8,58,No,5,1,9,49
5,81,Yes,5,7,12,67
4,66,No,4,5,9,49
2,96,No,8,7,9,73
6,73,No,8,7,13,65
6,43,Yes,4,0,6,27
1,95,No,8,6,7,72
9,77,Yes,9,1,10,74
6,46,Yes,9,7,13,38
3,87,No,9,1,4,67
4,46,Yes,9,3,7,28
4,89,No,7,1,5,73
3,91,No,5,6,9,72
3,65,No,4,4,7,42
3,65,No,7,8,11,47
4,93,No,9,4,8,77
7,58,No,4,7,14,49
4,48,Nah,5,1,5,30
9,59,Yes,8,2,11,54
1,81,Yes,7,5,6,56
8,84,No,5,6,14,75
7,89,No,4,9,16,78
2,55,Yes,6,7,9,32
8,93,No,7,2,10,89
1,56,Yes,4,6,7,29
9,61,Yes,4,7,16,57
9,52,No,5,9,18,48
2,51,No,4,5,7,27
7,49,Yes,7,3,10,38
3,40,Yes,9,5,8,18
7,71,No,7,8,15,66
9,69,No,4,2,11,65
4,47,Yes,5,1,5,27
1,60,Yes,7,4,5,33
2,61,Yes,6,6,8,37
1,57,No,9,2,3,29
5,41,No,8,4,9,26
5,87,No,5,3,8,72
7,83,Yes,5,6,13,77
9,48,Yes,8,1,10,45
9,42,No,8,6,15,41
3,93,Yes,7,1,4,73
3,65,Yes,4,2,5,43
3,60,Yes,4,4,7,39
4,69,Yes,6,6,10,54
8,67,Y,9,5,13,62
6,75,No,4,6,12,63
8,65,No,6,5,13,59
1,73,No,6,0,1,46
8,47,No,5,4,12,42
4,49,No,5,0,4,30
1,87,Yes,9,6,7,63
8,94,Yes,7,3,11,89
4,82,Yes,8,4,8,62
6,89,No,8,0,6,77
8,93,Yes,9,7,15,88
4,53,Yes,6,3,7,35
3,79,Yes,9,2,5,60
9,94,No,8,0,9,92
3,54,Yes,6,3,6,38
9,56,Yes,8,2,11,56
2,92,N,7,7,9,70
2,57,No,5,8,10,35
2,71,Yes,5,4,6,47
6,77,No,6,8,14,66
3,62,Yes,9,0,3,43
9,85,No,8,6,15,81
4,62,Yes,4,6,10,43
1,74,Yes,7,5,6,46
4,78,No,8,3,7,61
1,54,No,4,8,9,27
5,92,No,7,2,7,77
4,63,No,7,0,4,43
8,67,Yes,5,1,9,60
8,55,No,6,2,10,48
7,55,Yes,8,1,8,47
3,79,Yes,7,5,8,60
1,78,Yes,8,6,7,53
1,45,No,7,4,5,19
3,41,Yes,9,4,7,23
6,93,Yes,5,6,12,81
7,52,No,6,5,12,41
6,83,Yes,4,7,13,71
6,86,Yes,4,8,14,75
6,98,Yes,9,1,7,89
3,48,No,5,1,4,28
6,73,Yes,7,0,6,60
8,56,Yes,5,6,14,54
2,66,Yess,6,3,5,41
5,68,No,4,8,13,52
1,76,No,8,5,6,53
1,82,N,4,6,7,52
5,61,Yes,6,6,11,47
3,90,Yes,7,7,10,71
4,63,Yes,5,3,7,42
3,46,Yes,4,2,5,21
1,73,Yes,4,2,3,48
1,87,No,8,9,10,64
5,51,Yes,5,7,12,38
6,62,Yes,8,2,8,49
3,54,No,8,7,10,35
9,72,No,7,1,10,73
5,96,Yes,4,4,9,81
8,52,No,9,4,12,47
1,62,No,5,6,7,36
5,77,No,7,4,9,63
3,71,Yes,9,8,11,52
1,84,No,7,2,3,58
4,89,Yes,7,8,12,77
5,74,No,6,0,5,58
7,40,Yes,6,2,9,33
1,86,Yes,7,3,4,67
3,97,Yes,6,5,8,76
2,84,No,5,9,11,62
9,44,No,4,7,16,37
6,96,No,9,6,12,86
3,52,Yes,5,7,10,37
8,93,No,4,5,13,88
8,44,No,6,5,13,38
2,99,Yes,9,5,7,76
6,71,No,5,2,8,57
7,90,Yes,8,9,16,82
2,60,No,7,3,5,35
2,63,Yes,4,5,7,41
1,99,Yes,4,6,7,75
8,57,No,8,2,10,51
1,60,Yes,8,3,4,34
9,93,No,7,5,14,92
6,49,No,6,0,6,39
7,63,No,5,6,13,56
7,79,No,5,0,7,69
3,86,Yes,5,9,12,69
2,60,Yes,6,8,10,40
9,64,Yes,7,9,18,63
8,91,No,5,8,16,86
7,99,No,4,8,15,89
9,96,Yes,4,3,12,94
4,98,Yes,4,1,5,79
4,62,No,8,6,10,44
1,61,No,8,3,4,33
8,43,No,6,4,12,36
3,73,Yes,5,0,3,50
7,95,No,8,9,16,94
2,45,Yes,4,5,7,22
2,67,No,8,6,8,44
7,70,Yes,4,2,9,60
6,74,No,5,9,15,64
3,78,Yes,6,1,4,58
9,81,Yes,7,9,18,78
6,62,Yes,7,6,12,51
6,45,No,4,0,6,30
1,55,Yes,8,1,2,29
4,41,Yes,8,2,6,22
6,63,No,4,3,9,51
6,56,Yes,5,4,10,45
5,84,Yes,4,3,8,70
1,40,No,5,9,10,10
8,45,Yes,6,2,10,38
5,44,No,6,0,5,30
5,96,Yes,4,6,11,82
7,84,No,6,9,16,74
4,99,Yes,8,5,9,87
6,94,Yes,5,1,7,77
4,89,Yes,7,1,5,72
3,68,No,7,2,5,51
7,51,Yes,6,7,14,40
8,78,Yes,5,7,15,72
4,86,No,8,9,13,68
2,42,No,7,9,11,22
3,87,No,8,9,12,67
1,40,Yes,8,9,10,18
8,66,Yes,7,7,15,64
3,87,Yes,7,6,9,66
7,63,No,6,1,8,50
5,83,No,5,0,5,68
5,58,Yes,4,5,10,44
7,98,Yes,5,7,14,90
9,47,No,4,0,9,41
5,94,No,7,2,7,83
1,83,No,8,0,1,57
1,86,Yes,5,9,10,64
2,41,No,8,8,10,18
6,69,No,5,6,12,62
9,69,No,9,7,16,66
8,88,No,5,8,16,85
5,78,Yes,8,2,7,62
1,84,No,9,9,10,62
7,71,Yes,6,1,8,62
5,40,Yes,7,5,10,26
6,77,No,6,4,10,66
7,52,No,6,3,10,43
3,50,Yes,5,5,8,30
3,49,No,7,5,8,25
5,87,Yes,9,2,7,77
6,98,No,5,1,7,88
9,65,Yes,4,8,17,62
5,95,Yes,5,7,12,82
1,94,Yes,9,3,4,73
4,59,No,8,5,9,44
5,56,Yes,5,2,7,40
5,56,Yes,4,7,12,39
7,43,No,5,2,9,34
4,44,No,9,1,5,27
1,99,Yes,4,6,7,73
5,62,Yes,7,2,7,46
7,85,No,9,8,15,78
6,91,Yes,5,2,8,80
5,49,No,4,7,12,33
4,85,No,9,1,5,68
2,67,No,7,8,10,45
4,72,Yes,8,0,4,56
3,82,No,6,2,5,58
1,65,Yes,4,1,2,37
8,94,Yes,8,6,14,88
5,89,No,7,4,9,75
4,87,No,8,7,11,70
8,68,No,5,1,9,62
7,66,No,6,7,14,57
2,57,Yes,4,6,8,32
1,79,Yes,9,4,5,53
4,99,No,7,1,5,82
8,49,Yes,6,9,17,41
2,97,No,7,6,8,75
3,81,Yes,8,9,12,63
1,44,Yes,7,3,4,17
1,49,Yes,7,3,4,24
3,89,No,8,7,10,69
5,60,Yes,8,5,10,47
3,63,Yes,6,8,11,43
1,77,Yes,4,1,2,48
1,42,Yes,8,4,5,17
8,79,No,6,5,13,75
2,70,Yes,7,7,9,54
3,80,No,7,3,6,59
2,76,No,9,6,8,56
3,41,Yes,5,6,9,20
7,41,Yes,8,3,10,34
1,78,No,6,0,1,54
8,88,No,9,2,10,83
2,81,No,6,1,3,59
3,83,Yes,4,2,5,63
9,73,Yes,9,4,13,72
7,81,No,6,0,7,70
4,59,No,8,4,8,41
5,72,No,6,1,6,54
2,43,Yes,5,3,5,21
8,84,Yes,7,5,13,83
4,83,No,7,8,12,64
9,50,Yes,9,9,18,51
5,81,No,6,5,10,66
9,86,Yes,6,9,18,83
4,44,No,6,1,5,26
5,64,Yes,6,7,12,49
9,88,Yes,5,4,13,85
8,99,Yes,8,8,16,95
3,76,Yes,5,9,12,56
1,73,Yes,5,8,9,50
3,48,Yes,5,3,6,23
4,45,Yes,7,0,4,26
2,57,No,5,8,10,30
1,53,No,6,8,9,28
7,58,No,5,7,14,48
8,53,Yes,6,4,12,46
7,79,Yes,9,4,11,73
5,56,Yes,8,9,14,45
1,99,No,7,5,6,76
7,74,No,8,0,7,71
7,68,No,9,8,15,60
9,81,No,8,4,13,77
3,56,No,7,6,9,36
9,98,No,6,7,16,96
1,82,Yes,9,4,5,62
1,47,No,9,2,3,22
4,40,Yes,6,5,9,21
9,84,No,6,6,15,79
6,92,No,7,3,9,82
3,75,Yes,5,8,11,55
1,46,Yes,4,3,4,22
4,85,Yes,5,9,13,70
9,44,No,5,1,10,37
3,63,No,8,8,11,42
9,67,Yes,4,3,12,64
7,82,No,6,3,10,72
4,56,Yes,5,9,13,42
3,76,No,7,0,3,56
5,59,No,5,1,6,43
5,42,No,6,2,7,24
3,76,Yes,5,6,9,55
9,65,No,9,8,17,64
4,54,Yes,8,4,8,34
5,90,Yes,8,3,8,78
4,87,Yes,5,1,5,71
5,47,Yes,8,6,11,33
7,52,Yes,7,5,12,46
9,87,Yes,4,6,15,86
7,42,Yes,5,7,14,34
5,40,Yes,7,8,13,26
7,48,Yes,9,9,16,44
5,70,No,7,4,9,53
3,80,Yes,7,4,7,61
7,93,No,9,3,10,84
2,65,Yes,6,2,4,40
9,56,No,5,6,15,53
1,95,No,5,4,5,67
6,73,No,5,6,12,58
7,48,No,4,1,8,41
8,95,No,7,8,16,89
9,90,No,5,8,17,85
2,52,Yes,8,8,10,33
2,44,Yes,6,4,6,20
5,80,Yes,9,9,14,66
5,52,Yes,9,8,13,38
6,40,Yes,4,0,6,25
3,64,Yes,9,1,4,43
8,86,No,6,9,17,79
1,43,Yes,7,4,5,16
6,75,No,9,4,10,67
4,91,No,9,5,9,80
1,49,No,8,7,8,26
7,67,No,7,0,7,57
9,96,No,5,9,18,91
4,45,No,6,8,12,29
4,66,Yes,9,3,7,48
6,95,No,8,7,13,84
3,51,No,6,4,7,33
6,91,Yes,4,0,6,82
7,87,Yes,8,8,15,81
3,42,Yes,4,7,10,24
7,85,Yes,9,4,11,81
3,72,Yes,8,3,6,54
2,49,Yes,5,7,9,25
4,70,Yes,6,8,12,53
8,54,No,6,6,14,48
9,46,Yes,7,3,12,40
7,75,No,8,6,13,66
1,53,Yes,8,5,6,29
3,95,Yes,4,2,5,73
9,87,No,8,9,18,89
1,53,Yes,6,2,3,27
9,42,Yes,8,0,9,40
8,88,Yes,7,4,12,83
1,92,Yes,7,7,8,69
6,85,Yes,6,5,11,72
5,89,Yes,6,7,12,77
6,42,Yes,6,6,12,32
5,61,No,8,1,6,49
6,58,Yes,8,7,13,44
5,74,No,5,3,8,57
5,51,No,9,4,9,34
4,93,No,9,7,11,76
3,44,No,4,4,7,22
3,49,No,8,4,7,30
4,80,No,5,5,9,67
9,72,No,5,6,15,71
2,52,Yes,7,8,10,29
9,74,Yes,8,6,15,74
1,90,Yes,5,5,6,67
1,71,No,7,9,10,46
5,50,Yes,4,3,8,34
6,87,No,7,9,15,76
6,77,No,4,1,7,64
3,63,Yes,9,8,11,46
7,74,No,9,9,16,68
9,58,No,6,4,13,58
8,45,Yes,6,4,12,41
6,79,No,7,2,8,64
8,93,Yes,6,2,10,84
5,84,No,8,0,5,70
8,83,No,7,4,12,77
4,81,Yes,5,2,6,60
8,74,Yes,8,1,9,65
2,43,Yes,7,8,10,21
5,72,No,9,9,14,60
9,52,No,4,5,14,48
4,95,Yes,6,2,6,77
6,75,Yes,6,6,12,63
1,93,Yes,6,8,9,68
9,82,No,7,8,17,81
1,58,No,8,0,1,29
5,82,Yes,4,1,6,66
4,51,Yes,6,7,11,36
3,50,Yes,8,0,3,29
6,45,No,5,2,8,32
2,51,Yes,9,6,8,31
3,66,Yes,5,7,10,45
5,80,Yes,4,4,9,65
9,64,No,6,1,10,57
2,81,No,5,2,4,58
8,42,Yes,9,8,16,38
2,42,No,8,9,11,22
5,59,Yes,8,6,11,48
7,67,Yes,5,0,7,59
8,62,Yes,6,2,10,58
1,87,Yes,9,8,9,62
6,42,No,4,6,12,30
1,81,Yes,6,1,2,56
2,63,Yes,7,5,7,40
1,82,No,5,8,9,59
5,79,Yes,7,3,8,65
9,45,No,5,9,18,43
6,59,Yes,4,1,7,48
1,50,Yes,6,2,3,24
1,71,Yes,9,6,7,51
2,99,Yes,6,3,5,81
9,66,No,5,6,15,62
3,60,Yes,8,4,7,43
1,83,No,7,7,8,63
5,87,No,9,7,12,73
7,89,No,9,4,11,76
6,52,Yes,6,6,12,43
1,61,No,6,5,6,34
5,74,No,5,7,12,57
5,86,No,8,8,13,72
6,61,Yes,7,4,10,47
3,67,Yes,8,6,9,52
5,60,No,9,0,5,49
7,85,No,8,7,14,77
5,57,Yes,5,2,7,41
5,70,No,8,0,5,56
5,99,No,7,5,10,89
3,85,No,9,7,10,65
1,76,Yes,4,2,3,49
5,60,No,9,0,5,48
9,53,No,4,2,11,47
1,64,Yes,7,4,5,37
3,66,No,9,7,10,48
4,79,Yes,9,8,12,61
1,99,Yes,9,8,9,77
1,99,Yes,9,3,4,75
8,62,No,5,7,15,57
2,70,No,6,4,6,45
8,86,No,9,2,10,82
7,99,No,5,4,11,90
2,68,No,7,1,3,42
6,86,No,9,5,11,74
6,69,No,8,0,6,60
3,90,No,9,5,8,73
2,65,Yes,9,4,6,40
1,59,No,4,8,9,32
6,77,No,8,6,12,67
5,58,Yes,9,5,10,46
9,66,No,9,6,15,65
1,64,Yes,9,9,10,42
7,79,No,5,4,11,69
5,77,No,7,0,5,62
5,91,Yes,4,8,13,75
2,62,Yes,9,4,6,40
3,68,No,7,3,6,43
7,54,Yes,4,5,12,42
6,98,No,4,4,10,84
2,42,No,4,0,2,15
6,49,No,9,1,7,39
2,54,No,5,3,5,26
2,95,No,9,7,9,73
2,55,No,9,4,6,34
3,56,Yes,7,6,9,34
2,58,Yes,6,1,3,37
4,50,Yes,6,7,11,34
9,87,No,6,4,13,85
6,44,Yes,7,3,9,31
1,44,No,8,8,9,18
8,97,Yes,7,5,13,92
7,53,No,4,3,10,44
3,89,No,9,7,10,72
1,65,No,8,2,3,40
5,47,No,4,9,14,31
4,44,No,9,1,5,25
8,46,Yes,9,6,14,44
1,55,No,4,3,4,27
1,94,Yes,7,3,4,66
4,53,No,6,9,13,34
8,76,No,8,8,16,70
5,95,No,9,1,6,81
2,80,Yes,5,0,2,56
6,43,No,9,6,12,30
5,75,Yes,6,7,12,60
2,87,No,9,2,4,64
3,95,Yes,5,1,4,74
9,56,Yes,7,3,12,52
7,86,Yes,9,1,8,84
7,75,No,8,1,8,66
6,45,No,7,4,10,32
8,55,Yes,5,9,17,47
4,68,No,4,4,8,51
8,75,No,9,7,15,67
4,77,No,7,8,12,57
8,76,Yes,9,1,9,71
9,87,Yes,8,0,9,86
3,96,No,9,2,5,77
3,87,Yes,7,5,8,72
2,49,No,6,4,6,24
3,80,No,7,7,10,60
3,75,Yes,5,7,10,55
5,68,Yes,7,1,6,54
5,53,No,8,8,13,39
2,43,No,7,3,5,19
6,83,No,7,0,6,68
5,95,Yes,8,1,6,83
6,81,Yes,7,5,11,72
1,75,No,8,4,5,49
5,89,No,5,6,11,74
9,84,Yes,8,8,17,86
2,52,No,5,5,7,26
1,85,Yes,5,5,6,60
9,57,Yes,8,1,10,54
9,72,No,7,6,15,73
9,60,No,9,1,10,61
6,55,Yes,6,6,12,45
8,54,No,9,7,15,57
1,93,Yes,8,0,1,68
4,96,Yes,7,8,12,72
1,44,Yes,5,7,8,17
8,45,No,4,8,16,37
1,77,No,6,4,5,54
3,42,No,9,3,6,22
4,87,Yes,7,0,4,73
8,51,Yes,6,8,16,47
6,75,Yes,4,3,9,63
7,72,Yes,4,3,10,63
8,75,No,4,3,11,68
2,72,No,9,1,3,52
8,70,No,8,3,11,64
3,60,Yes,6,1,4,38
7,66,Yes,8,7,14,60
3,66,No,4,6,9,45
7,47,Yes,7,9,16,39
2,95,No,4,1,3,75
6,76,Yes,8,1,7,67
3,71,Yes,4,1,4,48
3,65,Yes,4,0,3,44
9,41,Yes,8,5,14,37
7,51,Yes,8,5,12,41
5,61,No,7,0,5,47
7,56,No,8,0,7,45
9,46,No,7,5,14,43
1,82,Yes,5,5,6,54
7,43,No,5,3,10,32
6,76,No,8,2,8,64
9,77,Yes,4,8,17,74
1,71,Yes,6,5,6,50
4,50,No,4,0,4,33
9,40,No,8,2,11,36
4,64,No,7,0,4,45
3,81,No,4,2,5,58
9,91,No,5,1,10,85
2,63,Yes,9,4,6,41
4,92,No,8,2,6,78
6,82,No,4,6,12,63
2,95,No,9,7,9,76
8,56,No,4,6,14,51
8,47,No,7,1,9,36
1,98,No,7,9,10,74
3,84,Yes,7,9,12,65
9,66,Yes,9,6,15,65
5,91,Yes,6,9,14,79
6,57,No,9,2,8,46
4,66,No,8,6,10,47
2,61,Yes,8,0,2,42
8,55,No,5,1,9,46
6,41,No,5,9,15,34
5,44,No,8,0,5,27
9,57,Yes,4,8,17,52
1,42,Yes,8,1,2,17
5,66,Yes,6,1,6,53
6,93,No,5,5,11,84
5,56,Yes,5,6,11,39
6,55,Yes,9,1,7,44
6,45,Yes,5,3,9,36
7,90,No,8,2,9,81
4,46,Yes,5,4,8,30
8,89,Yes,5,8,16,80
7,53,No,9,1,8,41
9,77,Yes,8,4,13,77
7,79,No,4,7,14,69
3,54,No,5,5,8,34
3,86,Yes,5,3,6,64
8,86,Yes,5,9,17,78
5,87,Yes,6,7,12,74
4,72,No,8,2,6,52
8,82,Yes,5,3,11,76
6,66,Yes,6,8,14,53
2,68,Yes,4,4,6,46
4,96,No,4,5,9,77
4,76,No,9,1,5,59
6,44,No,9,8,14,35
6,68,Yes,9,7,13,61
1,71,Yes,6,6,7,46
8,99,No,4,8,16,97
6,92,Yes,9,4,10,86
3,45,Yes,7,4,7,24
9,41,No,9,8,17,37
2,45,No,4,4,6,18
8,85,No,7,8,16,84
3,82,Yes,6,0,3,59
5,43,Yes,7,9,14,29
6,95,Yes,4,9,15,84
6,68,No,5,7,13,60
4,98,No,7,2,6,78
3,64,Yes,4,7,10,46
4,48,No,9,4,8,31
1,95,No,5,1,2,68
4,42,Yes,6,8,12,25
1,65,No,6,3,4,37
1,87,Yes,8,6,7,62
6,82,No,6,7,13,69
5,66,Yes,8,6,11,50
4,75,No,6,5,9,55
3,71,Yes,6,6,9,54
1,40,No,6,3,4,12
6,96,No,8,9,15,88
2,92,No,9,0,2,69
8,93,No,8,4,12,88
5,55,No,7,7,12,41
7,90,Yes,4,9,16,83
2,87,Yes,4,5,7,62
8,50,Yes,9,4,12,45
2,65,No,4,1,3,42
4,79,Yes,6,9,13,65
1,94,No,9,4,5,73
5,40,No,4,9,14,23
9,65,Yes,8,2,11,61
1,67,Yes,7,1,2,41
9,92,No,5,2,11,85
8,97,No,7,3,11,93
6,48,Yes,4,1,7,35
7,99,Yes,9,3,10,92
3,98,No,4,3,6,79
1,83,No,8,5,6,57
5,61,Yes,7,4,9,49
2,47,No,8,6,8,28
5,97,No,8,6,11,85
8,88,Yes,5,2,10,82
9,81,Yes,8,8,17,80
2,66,No,8,6,8,41
3,78,No,5,6,9,57
3,58,Yes,6,1,4,41
1,64,No,6,9,10,43
8,77,Yes,9,2,10,73
6,60,No,5,2,8,46
8,63,Yes,9,5,13,61
9,63,No,9,3,12,61
5,99,No,8,3,8,87
3,99,No,9,0,3,78
5,58,Yes,4,5,10,43
5,89,Yes,7,7,12,75
5,86,Yes,4,7,12,72
3,41,No,4,7,10,18
4,53,No,8,4,8,36
9,92,Yes,7,9,18,92
9,71,Yes,9,5,14,71
2,81,No,7,4,6,58
8,71,No,9,3,11,69
8,67,No,6,3,11,58
7,87,No,5,3,10,74
8,78,Yes,8,3,11,72
3,79,Yes,9,5,8,61
6,81,No,9,5,11,74
1,86,No,7,4,5,60
7,79,No,8,8,15,70
1,52,Yes,9,7,8,27
9,51,Yes,6,9,18,49
1,47,No,4,5,6,17
1,54,No,9,8,9,34
7,65,No,7,4,11,51
2,51,No,6,9,11,27
5,82,No,8,3,8,67
8,90,No,9,5,13,84
8,85,Yes,6,3,11,81
3,66,Yes,6,7,10,45
7,57,Yes,6,6,13,50
3,84,No,6,4,7,67
6,75,No,6,9,15,67
6,88,No,6,5,11,77
3,90,Yes,5,6,9,70
7,66,No,8,1,8,59
3,48,Yes,4,8,11,27
8,94,No,8,6,14,88
4,78,No,7,7,11,60
1,40,No,7,4,5,14
4,46,Yes,8,2,6,27
7,65,Yes,6,1,8,54
4,46,Yes,5,1,5,32
6,91,No,4,2,8,79
9,46,Yes,9,0,9,44
1,47,No,9,0,1,20
5,55,No,6,6,11,42
7,42,Yes,8,9,16,33
1,84,Yes,9,7,8,58
4,49,No,8,5,9,31
6,89,No,5,6,12,75
2,46,No,5,0,2,22
5,60,No,8,0,5,46
1,92,Yes,6,8,9,68
6,76,Yes,6,4,10,66
6,70,Yes,6,6,12,60
4,62,No,9,5,9,44
8,96,No,4,3,11,90
4,66,No,4,0,4,47
8,95,Yes,6,3,11,88
8,61,No,8,9,17,56
5,78,No,5,9,14,66
4,96,Yes,7,7,11,78
2,66,Yes,5,0,2,43
3,93,No,5,1,4,72
3,88,Yes,7,7,10,69
4,43,No,6,1,5,24
4,63,Yes,5,9,13,47
5,62,No,7,8,13,45
4,87,Yes,9,2,6,72
8,58,Yes,8,2,10,51
6,81,Yes,8,5,11,73
6,42,Yes,8,2,8,28
8,66,No,6,8,16,56
7,42,No,5,7,14,29
8,67,Yes,5,3,11,60
2,56,No,4,5,7,28
9,70,Yes,8,7,16,66
1,49,Yes,6,3,4,21
8,88,No,7,4,12,84
4,61,No,6,6,10,42
4,69,No,5,7,11,51
5,88,No,8,6,11,74
8,60,No,4,7,15,50
5,75,No,9,3,8,62
8,92,No,6,0,8,90
1,62,Yes,4,5,6,32
9,77,No,5,4,13,71
6,51,Yes,7,3,9,37
3,64,No,6,1,4,42
8,93,No,9,0,8,85
9,96,Yes,5,8,17,96
6,59,Yes,8,1,7,51
7,88,Yes,6,8,15,82
1,88,Yes,4,5,6,64
5,81,No,6,5,10,67
5,46,No,5,1,6,32
4,68,Yes,5,5,9,50
6,87,Yes,4,2,8,73
7,68,No,9,6,13,62
9,52,No,5,9,18,48
1,42,Yes,6,3,4,20
6,41,No,9,8,14,33
7,55,No,4,4,11,43
3,69,Yes,5,9,12,49
8,77,Yes,5,2,10,70
5,45,Yes,6,0,5,28
9,84,Yes,5,0,9,82
5,46,No,6,3,8,29
9,44,Yes,8,9,18,42
4,95,No,9,9,13,79
9,46,No,6,3,12,41
5,73,No,7,8,13,61
9,71,No,5,7,16,69
3,88,Yes,8,3,6,68
4,52,No,9,5,9,38
9,69,Yes,4,6,15,67
6,64,No,7,9,15,54
2,60,Yes,4,7,9,39
7,99,No,7,3,10,93
2,98,No,8,0,2,76
2,60,Yes,9,4,6,39
1,67,Yes,8,0,1,38
3,87,Yes,8,3,6,69
6,97,Yes,7,6,12,88
8,59,No,6,6,14,54
9,73,No,9,0,9,68
7,44,No,4,8,15,33
4,57,No,6,1,5,40
6,99,No,6,4,10,87
5,78,Yes,5,5,10,64
8,82,Yes,4,0,8,70
1,96,No,7,1,2,70
1,96,Yes,5,6,7,72
6,50,No,5,5,11,38
2,93,No,8,5,7,71
5,56,Yes,7,5,10,40
1,87,No,6,6,7,58
7,84,Yes,9,9,16,77
1,61,No,6,8,9,38
4,76,Yes,6,8,12,60
9,59,No,8,1,10,57
1,87,No,6,1,2,63
4,99,Yes,4,4,8,82
6,93,No,6,9,15,84
6,93,No,6,6,12,84
8,87,Yes,4,2,10,77
1,87,Yes,8,2,3,61
7,85,Yes,5,3,10,73
1,45,No,7,2,3,15
7,73,Yes,8,2,9,64
3,53,Yes,6,7,10,33
8,87,Yes,5,6,14,78
3,62,No,7,6,9,43
1,59,Yes,7,9,10,34
8,52,No,7,1,9,48
3,86,No,4,8,11,66
2,83,Yes,4,5,7,60
1,80,No,5,2,3,53
3,71,No,6,8,11,51
2,65,No,5,8,10,43
2,89,No,6,5,7,68
6,92,No,8,9,15,80
1,53,Yes,7,5,6,26
2,91,Yes,7,7,9,70
6,96,Yes,4,7,13,85
3,75,No,8,5,8,57
4,47,Yes,9,6,10,30
1,79,No,8,3,4,56
8,61,No,6,0,8,53
7,61,No,8,3,10,52
7,55,No,4,7,14,47
3,66,Yes,6,7,10,48
3,95,No,5,1,4,78
2,99,Yes,6,6,8,79
1,99,Yes,5,0,1,75
7,49,No,9,1,8,40
7,64,Yes,6,7,14,59
2,70,Yes,7,9,11,49
7,60,Yes,9,3,10,48
8,66,No,5,2,10,60
1,56,No,4,1,2,29
9,72,No,9,5,14,68
7,70,Yes,9,3,10,63
3,89,Yes,9,2,5,71
8,81,No,5,2,10,76
7,65,No,5,9,16,57
8,60,Yes,6,2,10,54
6,75,No,7,7,13,61
9,40,No,9,8,17,34
5,43,Yes,6,8,13,32
3,43,Yes,6,4,7,23
3,65,No,7,0,3,44
1,43,No,6,9,10,18
8,88,No,7,4,12,82
2,48,No,4,0,2,18
3,69,Yes,7,8,11,52
8,90,No,8,9,17,88
8,84,No,7,7,15,78
4,43,Yes,7,6,10,26
4,44,Yes,8,1,5,26
5,84,Yes,7,1,6,74
6,62,Yes,5,3,9,52
5,55,Yes,6,8,13,40
7,61,Yes,6,8,15,54
2,76,Yes,4,7,9,51
7,47,No,4,4,11,35
7,87,No,8,6,13,79
1,72,Yes,5,8,9,45
7,94,No,4,2,9,81
5,99,No,6,3,8,87
3,77,Yes,4,1,4,56
3,82,Yes,4,8,11,65
4,55,Yes,7,6,10,38
2,44,Yes,4,5,7,17
2,55,Yes,8,4,6,35
1,46,No,6,6,7,20
5,90,No,8,2,7,75
4,40,Yes,8,4,8,26
2,48,Yes,9,1,3,23
3,57,No,5,4,7,38
7,84,No,9,6,13,78
7,97,No,9,9,16,91
4,86,Yes,7,6,10,67
5,42,Yes,8,8,13,31
5,63,No,5,2,7,49
6,67,Yes,6,7,13,57
9,49,No,6,4,13,45
2,48,Yes,5,6,8,22
5,52,Yes,8,0,5,35
3,87,No,8,0,3,65
4,74,No,7,3,7,53
6,93,Yes,7,4,10,79
8,62,No,9,9,17,57
1,86,Yes,6,2,3,58
8,56,No,7,5,13,50
7,85,No,5,2,9,75
1,46,Yes,6,4,5,17
2,91,Yes,8,0,2,70
3,55,Yes,6,2,5,36
1,92,No,4,6,7,61
9,79,No,6,2,11,78
8,75,Yes,7,4,12,71
2,59,No,5,6,8,36
9,63,Yes,8,1,10,63
7,86,Yes,8,2,9,78
9,44,Yes,7,3,12,39
6,84,Yes,7,4,10,70
6,45,Yes,7,8,14,34
4,67,No,4,8,12,49
2,98,No,5,3,5,71
7,44,Yes,4,8,15,34
5,88,No,7,3,8,77
6,78,Yes,5,1,7,67
2,77,No,7,9,11,52
5,41,No,5,0,5,25
4,82,Yes,8,6,10,68
9,78,No,4,3,12,76
6,93,Yes,9,7,13,85
2,60,No,7,7,9,40
1,79,Yes,7,7,8,56
5,76,Yes,6,5,10,62
9,98,Yes,9,8,17,99
6,57,Yes,8,3,9,46
7,93,Yes,7,4,11,86
5,87,Yes,4,3,8,73
6,85,No,8,4,10,74
5,51,Yes,7,1,6,37
9,56,No,4,4,13,50
6,76,Yes,6,9,15,65
8,85,No,6,7,15,79
2,77,Yes,4,8,10,53
9,54,Yes,8,6,15,55
5,46,No,4,6,11,31
7,53,Yes,9,5,12,47
1,89,Yes,4,1,2,63
5,40,Yes,6,9,14,27
2,77,Yes,6,9,11,53
6,42,No,6,8,14,33
1,76,Yes,9,4,5,56
3,83,No,7,5,8,65
5,70,Yes,9,0,5,55
4,82,Yes,7,4,8,67
3,52,Yes,9,5,8,32
5,87,Yes,5,9,14,73
8,57,No,7,1,9,45
4,56,Yes,8,6,10,43
1,56,Yes,8,3,4,32
7,50,Yes,6,4,11,42
8,59,No,9,2,10,55
3,49,No,4,4,7,28
6,68,No,6,3,9,58
2,87,No,4,9,11,67
7,73,Yes,9,5,12,66
8,56,Yes,6,1,9,46
6,93,No,6,2,8,79
6,91,Yes,8,9,15,83
5,81,Yes,4,0,5,63
8,52,No,5,6,14,45
1,83,Yes,5,8,9,63
4,86,No,6,1,5,70
4,78,No,9,6,10,58
3,66,No,6,2,5,50
3,93,No,8,4,7,77
4,92,No,4,5,9,75
1,65,No,6,7,8,40
2,67,Yes,9,3,5,43
9,52,Yes,5,1,10,47
2,51,Yes,4,2,4,22
5,83,No,6,7,12,71
9,67,No,4,6,15,63
9,41,No,8,5,14,37
8,76,Yes,5,4,12,72
1,96,Yes,9,4,5,73
1,96,No,4,0,1,72
9,73,No,5,5,14,68
8,62,No,6,8,16,59
9,97,No,9,7,16,97
7,91,No,9,9,16,83
3,84,Yes,7,0,3,65
3,68,No,4,5,8,47
2,74,No,5,2,4,51
5,50,No,4,5,10,32
3,87,No,6,8,11,63
6,72,Yes,6,5,11,60
2,90,No,9,7,9,70
3,50,No,9,5,8,32
5,48,No,5,5,10,32
1,53,Yes,8,6,7,29
1,48,No,4,9,10,21
9,78,Yes,4,3,12,74
7,87,No,6,7,14,81
1,42,No,4,3,4,11
8,68,No,5,6,14,65
3,58,No,7,0,3,37
8,75,No,9,8,16,75
5,71,No,6,9,14,61
1,46,No,9,8,9,17
7,94,No,9,6,13,87
5,67,No,9,7,12,52
6,83,Yes,7,1,7,71
6,57,Yes,4,9,15,46
8,99,Yes,8,9,17,99
9,44,Yes,9,6,15,40
2,62,No,5,0,2,42
9,94,No,9,2,11,91
9,61,Yes,9,5,14,57
7,65,Yes,4,4,11,58
1,81,Yes,5,4,5,55
7,51,Yes,4,8,15,46
5,79,No,9,5,10,64
6,58,Yes,4,2,8,45
7,86,No,4,1,8,78
5,40,No,6,8,13,24
7,42,No,7,9,16,36
9,66,Yes,8,3,12,65
3,57,Yes,7,4,7,35
8,89,No,7,8,16,87
2,69,Yes,5,4,6,45
7,41,Yes,6,6,13,35
2,44,No,6,1,3,18
4,68,No,4,1,5,46
7,72,Yes,7,3,10,63
3,81,No,8,7,10,62
2,59,Yes,5,1,3,35
7,69,Yes,6,9,16,63
1,81,No,4,6,7,58
8,44,No,8,0,8,37
3,89,Yes,7,8,11,74
2,60,No,8,9,11,40
3,97,Yes,6,5,8,78
5,54,No,5,0,5,38
8,59,Yes,7,9,17,55
7,47,No,5,5,12,39
7,88,Yes,9,4,11,84
7,70,Yes,8,4,11,60
8,51,No,8,4,12,47
1,60,Yes,4,3,4,34
4,69,Yes,7,6,10,54
6,66,Yes,8,8,14,56
9,83,Yes,6,3,12,82
2,65,Yes,9,1,3,45
1,72,No,6,1,2,45
2,65,Yes,5,1,3,43
7,65,Yes,9,6,13,57
3,75,Yes,9,3,6,56
2,79,No,6,3,5,56
7,40,No,8,0,7,30
2,98,Yes,6,3,5,75
3,54,Yes,7,5,8,33
7,89,No,5,1,8,80
4,40,No,9,3,7,27
1,50,Yes,7,6,7,26
5,94,No,8,8,13,81
9,41,Yes,8,1,10,41
8,40,Yes,6,7,15,34
9,70,Yes,4,5,14,68
9,83,No,9,7,16,83
7,55,Yes,9,1,8,44
4,93,Yes,4,0,4,75
5,61,No,8,6,11,52
1,81,Yes,8,8,9,56
1,57,Yes,9,8,9,37
3,86,Yes,5,1,4,67
8,56,No,9,3,11,50
2,69,No,8,0,2,46
4,49,Yes,8,6,10,31
2,74,No,5,1,3,51
5,97,Yes,7,3,8,82
9,60,Yes,7,1,10,58
1,55,No,5,0,1,31
5,45,No,5,6,11,29
9,42,Yes,7,5,14,40
1,80,No,7,1,2,51
9,82,No,7,3,12,79
8,60,No,7,2,10,52
4,52,Yes,9,2,6,36
5,57,Yes,9,2,7,43
5,97,No,6,3,8,81
6,93,Yes,5,0,6,81
7,99,Yes,4,0,7,84
8,63,No,6,6,14,55
8,66,Yes,4,4,12,64
2,93,No,4,2,4,68
9,43,Yes,8,8,17,41
7,61,Yes,5,4,11,53
4,63,No,9,9,13,50
4,79,Yes,6,2,6,65
8,84,No,5,8,16,78
4,49,Yes,7,0,4,31
6,41,Yes,5,8,14,30
5,79,Yes,4,4,9,64
3,45,No,9,5,8,26
2,87,Yes,7,1,3,66
9,57,Yes,5,7,16,55
9,56,No,5,2,11,52
1,77,No,9,0,1,57
3,84,Yes,4,6,9,68
8,62,No,7,2,10,57
6,85,No,4,3,9,75
5,69,No,9,4,9,54
5,97,No,5,0,5,82
6,60,Yes,6,8,14,51
7,49,No,6,6,13,43
1,95,Yes,8,1,2,68
9,82,Yes,6,0,9,77
3,52,Yes,9,1,4,33
4,51,No,9,2,6,37
1,48,No,9,2,3,23
3,43,Yes,7,7,10,26
2,78,Yes,8,4,6,56
2,63,No,7,8,10,42
1,93,No,6,2,3,65
8,73,Yes,6,5,13,66
3,78,No,5,3,6,57
3,80,No,7,7,10,59
6,44,Yes,4,0,6,28
8,54,No,5,3,11,46
9,89,No,7,6,15,84
9,43,Yes,9,8,17,42
4,90,No,8,0,4,73
5,91,Yes,7,7,12,77
2,97,No,8,1,3,74
9,78,Yes,8,3,12,75
8,97,No,6,3,11,94
3,47,Yes,4,7,10,27
9,88,No,7,1,10,89
3,84,No,4,6,9,62
9,63,No,8,2,11,59
2,92,Yes,6,8,10,73
9,67,No,4,4,13,57
8,94,Yes,5,7,15,90
9,82,No,8,4,13,80
5,66,No,5,0,5,50
2,40,No,9,8,10,18
8,73,No,4,9,17,68
6,56,No,4,6,12,39
8,76,No,4,3,11,67
5,77,Yes,9,6,11,69
2,65,Yes,7,4,6,43
6,96,No,8,9,15,84
5,63,No,8,8,13,50
5,78,No,8,1,6,65
1,99,No,7,3,4,74
2,60,No,4,5,7,35
8,69,Yes,4,4,12,61
3,86,No,9,0,3,64
3,90,No,5,8,11,66
8,87,Yes,7,8,16,81
8,96,Yes,6,2,10,93
2,52,Yes,7,3,5,28
8,76,No,9,3,11,71
1,42,No,5,9,10,13
6,71,No,5,7,13,59
8,74,No,5,5,13,67
3,58,No,4,1,4,35
8,53,Yes,6,3,11,46
1,87,No,5,0,1,59
9,61,No,8,2,11,57
9,56,No,4,3,12,51
5,98,Yes,6,7,12,80
4,43,No,8,2,6,22
6,84,No,6,4,10,71
7,79,No,9,0,7,73
5,58,No,6,3,8,40
9,76,Yes,8,1,10,75
3,41,Yes,7,3,6,24
7,54,Yes,6,4,11,45
5,41,No,7,2,7,25
7,50,Yes,6,5,12,42
2,84,Yes,9,1,3,63
4,62,No,8,4,8,44
2,49,No,6,3,5,26
7,42,Yes,5,4,11,31
2,44,Yes,9,8,10,26
1,42,Yes,5,5,6,15
9,77,Yes,9,6,15,77
1,52,No,9,7,8,31
8,81,No,6,8,16,75
2,58,Yes,8,4,6,34
8,79,Yes,8,7,15,74
3,89,Yes,4,1,4,68
6,74,No,8,9,15,64
3,63,No,7,8,11,43
7,63,No,6,1,8,54
9,56,Yes,5,4,13,53
2,79,No,8,5,7,56
5,49,Yes,5,3,8,34
6,41,Yes,4,7,13,27
4,83,No,6,9,13,66
4,62,Yes,8,2,6,41
4,45,No,5,4,8,25
2,41,No,9,1,3,20
4,60,Yes,8,2,6,45
1,94,Yes,4,7,8,70
6,95,No,9,4,10,86
1,74,No,5,2,3,46
6,88,No,5,4,10,73
1,68,No,6,8,9,42
6,46,No,6,2,8,27
8,68,No,5,9,17,64
2,92,No,9,6,8,71
2,76,Yes,6,7,9,56
4,62,No,5,4,8,43
3,72,Yes,9,2,5,50
4,47,Yes,7,5,9,31
7,51,No,8,2,9,42
1,85,No,7,8,9,60
6,87,No,7,1,7,76
3,49,No,8,2,5,28
7,54,No,5,6,13,45
2,92,Yes,5,9,11,71
2,63,Yes,6,7,9,44
4,65,No,4,4,8,48
1,86,No,5,4,5,57
3,81,No,8,4,7,61
9,92,No,4,3,12,86
7,99,Yes,8,8,15,95
7,78,Yes,8,5,12,70
4,97,Yes,8,7,11,81
2,42,No,4,7,9,18
4,41,No,7,4,8,24
6,45,No,9,8,14,32
3,60,Yes,8,1,4,40
1,48,Yes,6,7,8,25
8,49,Yes,5,2,10,41
5,75,No,9,6,11,66
5,98,Yes,5,8,13,83
4,42,No,5,4,8,22
6,80,Yes,4,7,13,70
3,63,No,6,3,6,42
9,61,No,6,0,9,56
5,88,No,9,0,5,72
3,53,No,6,5,8,31
1,81,Yes,6,7,8,60
6,84,Yes,6,9,15,74
2,83,Yes,9,1,3,62
3,66,No,7,3,6,44
1,72,Yes,6,2,3,46
9,99,No,6,8,17,96
8,61,Yes,4,2,10,51
2,68,Yes,4,7,9,43
8,58,No,6,6,14,51
9,58,No,7,0,9,58
1,45,No,6,7,8,23
5,84,Yes,6,8,13,67
8,58,No,6,7,15,50
2,52,Yes,8,9,11,31
4,98,Yes,7,9,13,83
7,65,Yes,5,0,7,55
3,61,No,6,6,9,44
5,60,Yes,5,8,13,45
8,75,No,7,4,12,73
3,95,No,6,1,4,76
4,41,Yes,5,7,11,23
9,86,Yes,9,8,17,84
7,83,Yes,5,6,13,73
1,69,Yes,7,4,5,48
4,66,No,6,7,11,50
4,46,No,8,5,9,30
9,59,No,7,3,12,51
6,89,No,8,0,6,76
9,70,No,6,5,14,66
6,62,No,5,7,13,50
6,52,No,9,2,8,40
5,56,No,9,6,11,42
5,43,No,7,6,11,29
2,96,Yes,7,8,10,77
8,53,Yes,7,0,8,45
8,59,No,4,4,12,49
1,99,No,9,7,8,74
8,52,Yes,9,2,10,45
5,42,Yes,6,4,9,27
2,65,Yes,4,0,2,44
2,65,No,7,8,10,42
6,57,Yes,7,3,9,43
9,71,Yes,8,4,13,68
1,53,Yes,4,2,3,29
6,86,Yes,5,1,7,73
9,42,Yes,9,6,15,39
8,40,No,6,4,12,30
6,65,Yes,5,9,15,53
3,63,No,5,2,5,38
8,88,Yes,6,1,9,82
9,74,Yes,7,9,18,72
1,53,Yes,9,5,6,24
9,42,Yes,8,9,18,44
6,52,Yes,7,5,11,45
6,86,No,7,2,8,75
4,89,No,4,8,12,75
1,53,No,5,0,1,26
8,60,No,5,2,10,49
2,65,No,9,0,2,42
1,42,No,5,6,7,14
2,90,No,8,1,3,64
1,79,Yes,8,3,4,54
1,43,No,8,3,4,16
9,75,Yes,6,7,16,73
1,90,Yes,9,3,4,67
4,82,No,8,2,6,69
6,40,Yes,4,9,15,28
7,79,Yes,4,2,9,67
2,86,No,7,4,6,62
6,72,Yes,7,5,11,60
7,46,No,9,6,13,43
2,92,Yes,7,4,6,70
2,91,No,7,6,8,70
7,91,Yes,4,3,10,84
1,95,No,7,4,5,72
8,50,Yes,4,5,13,44
3,66,No,8,8,11,46
6,53,Yes,8,5,11,41
9,61,Yes,9,9,18,58
6,55,No,6,0,6,44
9,85,Yes,7,6,15,89
7,51,No,8,2,9,45
9,88,Yes,8,5,14,87
2,85,Yes,9,1,3,61
8,49,No,5,6,14,41
8,63,Yes,5,0,8,57
2,85,No,9,1,3,62
4,57,Yes,4,8,12,39
7,61,Yes,6,8,15,54
4,48,Yes,9,6,10,33
4,56,Yes,5,1,5,42
6,77,No,6,4,10,70
6,79,No,8,3,9,67
3,97,Yes,9,1,4,80
9,52,Yes,4,1,10,44
2,89,No,6,9,11,69
6,76,Yes,5,7,13,66
7,45,No,8,4,11,35
9,60,Yes,9,7,16,61
3,90,Yes,7,1,4,68
3,75,No,8,1,4,55
7,46,Yes,5,2,9,36
4,75,No,9,9,13,56
8,64,No,5,7,15,58
7,50,No,7,7,14,40
5,83,No,8,2,7,68
7,53,No,6,0,7,43
3,84,No,6,6,9,61
2,68,Yes,8,3,5,45
6,49,No,6,2,8,36
2,89,No,9,4,6,67
3,87,Yes,8,5,8,67
6,44,No,8,0,6,29
5,47,Yes,5,8,13,31
8,85,No,4,5,13,74
9,44,No,5,2,11,37
3,97,No,6,0,3,79
3,99,Yes,4,8,11,76
3,63,Yes,8,1,4,45
6,79,No,6,9,15,65
1,96,No,7,5,6,72
7,65,Yes,6,5,12,62
1,45,Yes,4,2,3,19
5,55,Yes,4,5,10,39
8,99,No,8,1,9,93
4,75,Yes,9,7,11,62
5,51,Yes,7,0,5,37
4,50,Yes,8,5,9,34
4,42,Yes,7,0,4,23
8,83,Yes,7,8,16,79
2,76,Yes,8,8,10,51
1,45,Yes,6,5,6,18
3,58,No,5,5,8,41
9,57,Yes,7,8,17,57
4,55,No,4,4,8,36
5,62,No,8,8,13,47
2,82,Yes,9,4,6,65
4,76,No,6,3,7,57
2,48,No,7,1,3,22
2,42,Yes,9,1,3,20
4,47,No,6,0,4,27
6,77,Yes,8,9,15,64
7,43,Yes,9,2,9,32
3,51,Yes,4,0,3,29
3,83,Yes,7,5,8,62
6,70,Yes,7,6,12,56
3,64,Yes,9,8,11,43
2,92,Yes,6,6,8,70
8,55,No,8,3,11,49
5,81,Yes,5,3,8,68
1,93,No,7,7,8,66
3,53,Yes,4,3,6,31
8,52,Yes,7,0,8,44
4,80,Yes,7,8,12,65
7,46,No,5,2,9,36
2,51,No,5,0,2,27
7,76,No,8,8,15,71
5,89,No,7,9,14,76
5,43,No,7,9,14,31
6,41,No,6,4,10,26
9,74,Yes,6,8,17,69
6,97,Yes,9,2,8,90
8,83,No,9,5,13,79
7,42,No,4,6,13,33
9,43,No,4,4,13,40
4,77,No,6,7,11,58
2,51,No,9,9,11,28
7,58,Yes,4,5,12,50
6,49,Yes,7,5,11,37
1,40,Yes,9,6,7,15
9,56,Yes,5,7,16,50
9,55,Yes,9,1,10,55
2,48,Yes,7,6,8,25
3,96,Yes,6,8,11,79
5,92,Yes,8,0,5,79
5,48,No,8,0,5,36
1,98,No,6,6,7,69
8,94,Yes,7,4,12,83
8,48,Yes,4,0,8,44
4,51,Yes,9,0,4,36
7,94,No,9,1,8,84
3,80,No,4,9,12,58
6,54,Yes,8,8,14,44
9,41,No,6,2,11,36
1,50,Yes,6,8,9,23
5,50,Yes,5,5,10,33
4,47,Yes,8,9,13,31
8,94,Yes,6,5,13,90
1,71,Yes,5,6,7,45
9,45,No,4,9,18,40
6,92,Yes,8,7,13,81
4,59,Yes,8,2,6,47
9,78,Yes,6,7,16,75
5,74,Yes,6,5,10,61
5,47,No,7,5,10,37
5,89,Yes,4,2,7,75
1,88,Yes,4,5,6,63
1,82,No,9,7,8,61
8,73,Yes,5,6,14,70
8,96,Yes,5,9,17,91
6,92,Yes,7,9,15,80
4,98,Yes,9,6,10,83
2,95,No,4,2,4,72
2,58,Yes,5,9,11,35
9,46,Yes,4,2,11,41
5,70,No,4,4,9,57
4,57,Yes,9,4,8,43
1,79,Yes,5,8,9,55
7,53,No,6,8,15,42
3,78,Yes,6,9,12,59
6,99,No,9,4,10,90
5,92,Yes,5,4,9,79
5,99,No,7,5,10,89
5,98,Yes,8,7,12,87
1,75,Yes,9,5,6,50
1,56,No,4,5,6,33
3,76,Yes,9,8,11,58
4,83,No,8,0,4,68
5,48,No,9,3,8,33
2,97,No,5,9,11,73
8,59,No,4,9,17,50
2,84,Yes,8,1,3,59
9,96,No,6,8,17,93
2,67,Yes,7,2,4,47
9,89,Yes,9,9,18,89
7,59,No,9,1,8,47
8,80,No,8,7,15,77
2,75,Yes,7,3,5,53
7,92,No,9,1,8,87
6,66,Yes,6,3,9,53
4,47,No,8,6,10,28
7,71,Yes,5,6,13,66
4,40,Yes,4,0,4,23
2,56,No,6,0,2,28
7,96,Yes,7,2,9,89
8,48,Yes,7,1,9,38
2,59,No,6,2,4,37
5,84,No,5,3,8,66
1,71,No,9,6,7,44
7,41,No,5,1,8,33
8,71,No,9,6,14,67
6,84,Yes,9,4,10,76
5,48,Yes,7,7,12,33
6,69,No,9,7,13,59
2,59,Yes,6,4,6,39
1,77,Yes,9,9,10,55
7,99,Yes,6,7,14,96
7,40,Yes,4,8,15,30
2,99,Yes,7,6,8,80
2,96,No,5,5,7,75
1,44,No,8,6,7,19
8,74,Yes,5,6,14,71
8,75,Yes,5,2,10,67
1,40,No,8,5,6,16
8,53,No,7,5,13,45
9,48,No,9,8,17,44
4,69,No,4,0,4,50
1,63,Yes,5,6,7,37
1,43,No,9,0,1,15
3,89,No,5,9,12,71
5,53,Yes,7,3,8,42
5,64,No,7,6,11,49
9,43,No,6,5,14,41
2,64,No,7,5,7,40
2,49,No,7,4,6,25
6,74,No,5,6,12,62
9,94,Yes,4,8,17,93
1,46,Yes,5,5,6,19
9,81,Yes,9,9,18,77
9,52,Yes,7,6,15,52
9,43,Yes,6,8,17,41
5,89,No,4,6,11,69
9,82,No,6,5,14,82
4,96,No,8,2,6,82
2,75,No,6,0,2,49
6,95,No,6,9,15,82
4,53,No,9,8,12,40
6,57,No,7,6,12,48
3,47,No,9,2,5,28
6,71,No,7,9,15,60
2,66,No,9,8,10,43
2,81,No,7,2,4,59
9,76,No,7,2,11,71
7,62,No,7,6,13,52
3,46,Yes,6,1,4,27
1,51,No,8,9,10,28
8,64,Yes,7,6,14,62
6,42,No,8,6,12,27
7,65,No,8,0,7,55
9,43,No,5,9,18,39
5,81,Yes,5,1,6,66
1,75,Yes,4,4,5,46
7,54,No,9,3,10,47
5,71,No,5,2,7,59
3,68,No,7,9,12,46
9,49,No,8,7,16,47
1,60,Yes,9,6,7,39
1,93,Yes,4,8,9,67
1,55,No,5,2,3,26
3,86,Yes,6,9,12,68
6,58,Yes,9,0,6,49
3,68,No,4,8,11,45
8,91,No,7,8,16,88
2,90,No,9,0,2,67
9,57,Yes,8,7,16,54
3,97,No,7,9,12,75
5,83,Yes,7,0,5,67
8,96,No,9,5,13,91
2,55,No,6,8,10,30
6,40,Yes,6,2,8,29
5,87,Yes,9,5,10,75
9,41,Yes,9,2,11,41
5,95,Yes,9,4,9,84
2,54,Yes,8,6,8,31
5,78,Yes,5,9,14,64
4,67,No,7,3,7,48
7,40,Yes,9,3,10,29
6,44,Yes,5,6,12,33
2,81,No,8,4,6,59
5,61,Yes,7,0,5,45
7,92,Yes,5,9,16,86
7,75,No,7,1,8,65
5,85,No,6,5,10,73
9,52,No,9,8,17,50
4,40,Yes,6,6,10,20
3,55,No,4,3,6,36
4,94,Yes,8,1,5,78
5,80,No,9,3,8,65
6,61,Yes,5,4,10,48
3,71,No,7,1,4,49
2,55,No,4,0,2,32
4,90,No,8,3,7,69
5,54,Yes,8,5,10,41
4,97,Yes,8,0,4,77
3,85,No,5,0,3,60
8,91,No,9,8,16,88
4,81,No,6,4,8,61
2,92,No,4,1,3,69
2,51,Yes,5,1,3,29
1,99,No,7,3,4,73
4,40,No,5,1,5,22
9,92,Yes,7,3,12,93
7,56,Yes,7,5,12,46
7,80,No,8,6,13,74
7,94,No,5,5,12,83
8,90,Yes,6,3,11,84
1,96,Yes,7,9,10,71
8,89,No,8,2,10,82
4,67,Yes,6,3,7,49
4,46,Yes,5,4,8,27
4,48,No,6,3,7,29
6,61,No,5,2,8,50
7,65,Yes,7,0,7,53
6,92,No,4,2,8,80
1,51,No,4,4,5,21
8,46,No,9,5,13,39
7,85,No,9,3,10,74
6,86,No,7,0,6,76
6,54,Yes,6,9,15,43
5,77,Yes,5,6,11,61
6,60,No,4,8,14,48
9,53,No,5,5,14,48
9,41,No,7,5,14,40
8,47,Yes,6,8,16,40
9,84,Yes,5,3,12,80
8,94,Yes,6,4,12,90
8,45,Yes,4,4,12,36
1,76,No,5,4,5,48
5,76,No,8,7,12,60
4,96,Yes,4,0,4,76
2,72,Yes,6,9,11,47
8,80,No,7,9,17,73
3,45,No,8,2,5,22
4,91,No,9,7,11,74
7,65,No,5,8,15,58
9,78,No,9,1,10,76
2,80,Yes,4,3,5,59
3,76,No,5,7,10,55
4,53,Yes,5,4,8,33
1,76,Yes,8,0,1,50
7,47,No,8,5,12,37
2,78,Yes,8,8,10,58
5,52,Yes,8,8,13,36
1,52,No,7,0,1,25
3,79,Yes,6,3,6,62
2,82,No,8,0,2,57
1,67,No,4,6,7,39
7,97,Yes,5,2,9,84
5,57,No,9,1,6,45
1,96,No,8,7,8,72
6,58,Yes,4,8,14,45
5,77,No,7,6,11,63
3,71,Yes,4,5,8,50
7,61,Yes,9,9,16,53
9,41,No,9,5,14,36
9,99,Yes,4,8,17,97
9,52,No,7,4,13,49
2,62,Yes,9,4,6,40
3,64,No,7,1,4,43
7,67,No,5,5,12,60
5,97,Yes,8,5,10,85
2,50,Yes,9,5,7,26
3,72,No,4,3,6,53
6,63,No,6,6,12,53
7,41,Yes,6,8,15,34
9,69,No,5,0,9,63
1,56,No,6,2,3,31
7,79,Yes,5,9,16,71
8,73,Yes,8,8,16,67
3,77,No,5,4,7,57
4,61,Yes,7,5,9,46
6,44,Yes,7,7,13,34
7,87,No,7,8,15,76
4,79,Yes,9,7,11,65
8,90,Yes,7,2,10,84
5,55,No,7,9,14,38
1,52,Yes,7,0,1,27
4,65,No,7,4,8,49
3,70,Yes,9,6,9,52
9,91,Yes,7,1,10,86
8,78,No,7,0,8,74
1,87,Yes,8,3,4,64
6,62,Yes,9,2,8,53
9,87,Yes,7,3,12,87
7,51,Yes,5,0,7,43
4,53,Yes,8,1,5,37
1,95,Yes,9,0,1,68
2,57,No,6,2,4,32
5,66,Yes,4,3,8,49
5,67,Yes,9,0,5,56
8,57,No,8,5,13,52
6,55,No,7,1,7,41
8,91,No,8,9,17,87
2,55,Yes,4,4,6,34
3,52,No,4,7,10,32
6,97,No,9,3,9,89
3,68,Yes,7,4,7,46
6,48,No,7,8,14,36
6,65,Yes,5,1,7,51
2,67,Yes,4,1,3,46
7,80,Yes,7,5,12,72
2,52,Yes,4,5,7,27
6,75,Yes,5,2,8,59
1,48,No,6,8,9,25
3,86,Yes,4,0,3,67
2,53,No,5,2,4,24
7,90,Yes,5,7,14,82
4,51,No,5,7,11,35
8,92,Yes,8,3,11,88
6,97,Yes,9,7,13,87
4,96,Yes,7,9,13,79
5,71,No,4,7,12,58
9,77,No,9,0,9,76
7,42,No,8,2,9,34
9,97,Yes,4,0,9,95
7,96,Yes,9,1,8,93
1,93,No,8,3,4,67
8,91,Yes,7,2,10,85
4,55,No,5,5,9,36
3,59,Yes,9,4,7,38
7,71,No,9,4,11,66
3,95,No,4,9,12,78
8,62,Yes,5,6,14,58
6,56,No,7,6,12,48
5,55,Yes,4,8,13,41
4,77,Yes,6,7,11,61
8,47,Yes,6,2,10,42
8,58,No,6,1,9,50
1,69,No,7,0,1,40
9,96,No,6,9,18,94
5,97,Yes,9,5,10,84
4,73,Yes,4,3,7,59
6,53,No,9,2,8,39
6,61,Yes,6,1,7,49
2,83,Yes,4,1,3,59
8,56,No,9,3,11,49
7,99,No,7,0,7,89
1,98,Yes,5,5,6,73
5,54,Yes,9,9,14,40
6,89,No,8,4,10,79
4,87,No,6,9,13,74
2,71,Yes,8,8,10,49
4,52,Yes,5,1,5,35
1,60,Yes,7,8,9,39
7,88,No,9,8,15,83
2,79,Yes,7,9,11,56
2,72,Yes,5,8,10,46
9,96,Yes,8,9,18,95
5,97,Yes,9,9,14,86
2,66,Yes,6,3,5,39
9,74,Yes,4,4,13,70
9,55,No,7,7,16,51
1,67,No,5,7,8,41
3,73,No,9,0,3,53
4,86,Yes,8,9,13,71
7,40,No,6,0,7,31
4,80,Yes,8,9,13,63
2,87,Yes,6,5,7,61
7,70,Yes,9,6,13,65
6,75,Yes,4,1,7,63
3,83,Yes,4,1,4,63
6,72,No,5,4,10,58
6,72,No,5,8,14,62
5,78,No,6,4,9,61
4,57,Yes,6,7,11,40
1,62,No,6,7,8,39
6,99,Yes,6,4,10,89
2,62,No,9,7,9,40
3,54,No,9,7,10,35
8,65,No,4,4,12,55
6,69,No,5,4,10,60
3,64,No,5,3,6,45
7,84,No,7,0,7,76
4,55,Yes,5,8,12,38
9,78,Yes,5,1,10,73
5,87,Yes,8,0,5,72
3,84,Yes,8,5,8,68
2,53,Yes,7,4,6,27
2,56,No,6,0,2,33
3,51,Yes,7,6,9,28
2,68,Yes,7,6,8,46
4,71,Yes,4,2,6,52
2,95,Yes,9,7,9,72
9,63,Yes,5,5,14,58
2,91,Yes,4,3,5,69
9,52,Yes,9,9,18,54
6,95,Yes,5,9,15,85
1,59,Yes,7,9,10,33
4,54,No,5,2,6,33
1,95,Yes,6,0,1,67
6,92,Yes,6,1,7,80
4,43,No,7,1,5,25
3,93,No,8,4,7,76
3,73,Yes,6,3,6,53
9,67,Yes,7,1,10,63
6,89,Yes,4,8,14,75
9,41,No,8,6,15,38
5,96,Yes,6,7,12,79
2,86,No,7,7,9,63
8,69,No,7,1,9,60
5,65,No,4,4,9,49
2,90,No,4,2,4,66
4,86,No,8,9,13,71
9,65,Yes,9,8,17,66
4,59,Yes,6,8,12,41
4,81,No,7,5,9,67
2,67,No,8,3,5,46
6,95,No,8,7,13,86
2,59,No,4,4,6,37
7,50,Yes,7,2,9,42
3,97,No,5,7,10,77
3,49,No,9,5,8,32
5,62,Yes,9,4,9,47
3,76,Yes,4,0,3,54
2,80,Yes,7,2,4,60
9,91,Yes,8,6,15,89
2,58,No,9,2,4,34
2,84,No,8,0,2,59
8,57,No,6,7,15,52
9,88,No,5,6,15,84
7,66,No,4,4,11,57
3,45,No,9,9,12,30
9,49,No,6,4,13,47
3,41,No,6,5,8,15
5,63,No,5,6,11,49
9,77,Yes,4,2,11,74
3,67,No,4,3,6,45
7,67,Yes,8,0,7,61
1,92,Yes,4,6,7,67
4,84,Yes,6,9,13,64
4,89,Yes,8,1,5,73
7,78,No,4,6,13,68
8,41,Yes,5,5,13,33
1,85,Yes,6,3,4,60
5,44,No,7,1,6,30
7,89,Yes,5,6,13,82
4,50,No,5,6,10,33
4,49,No,4,4,8,28
4,82,No,8,8,12,64
6,98,No,8,2,8,88
7,41,Yes,6,8,15,35
2,54,No,4,4,6,30
5,78,Yes,8,1,6,60
4,80,Yes,9,8,12,66
3,76,No,7,0,3,52
7,46,Yes,9,0,7,39
6,59,No,4,6,12,45
7,73,Yes,4,2,9,64
5,74,Yes,8,7,12,66
6,73,Yes,5,6,12,61
5,92,Yes,4,6,11,76
7,61,No,5,0,7,49
2,70,No,6,0,2,43
5,62,Yes,6,1,6,45
6,58,Yes,8,1,7,49
6,43,Yes,6,4,10,27
5,63,Yes,9,8,13,50
7,59,No,9,6,13,52
8,78,Yes,9,1,9,72
7,67,Yes,8,4,11,62
5,93,Yes,8,4,9,80
1,78,No,9,7,8,53
5,56,Yes,5,8,13,42
2,58,No,9,7,9,37
5,93,No,5,1,6,77
5,87,Yes,6,3,8,73
2,74,Yes,5,1,3,46
5,71,Yes,4,5,10,54
4,86,No,7,3,7,70
1,85,No,4,6,7,60
3,86,Yes,4,1,4,67
1,85,No,8,8,9,58
5,78,Yes,7,4,9,63
4,96,Yes,8,0,4,83
7,74,Yes,5,2,9,64
5,69,Yes,9,3,8,57
4,56,Yes,5,2,6,45
2,81,Yes,7,5,7,61
4,86,No,6,5,9,68
2,68,No,5,9,11,45
8,45,No,4,6,14,39
3,99,Yes,7,8,11,77
9,56,Yes,7,9,18,55
4,56,Yes,5,8,12,38
6,53,No,5,6,12,40
5,63,Yes,8,0,5,49
1,96,No,8,2,3,74
9,89,Yes,4,4,13,86
1,96,No,7,9,10,72
8,76,Yes,6,5,13,72
9,79,Yes,6,5,14,77
9,78,No,7,4,13,76
1,94,No,4,5,6,67
2,71,No,8,8,10,52
1,75,Yes,8,0,1,52
2,89,No,8,0,2,67
8,76,No,6,8,16,66
5,87,Yes,6,7,12,74
7,53,Yes,4,8,15,40
2,66,No,6,6,8,44
8,98,Yes,5,9,17,97
6,58,No,6,5,11,48
8,70,No,8,8,16,65
1,85,No,4,1,2,57
1,48,Yes,7,3,4,19
7,77,No,7,1,8,68
8,56,No,4,5,13,48
3,58,Yes,5,0,3,34
5,83,No,7,6,11,67
1,43,No,8,6,7,15
7,87,No,7,6,13,83
5,96,Yes,7,3,8,83
8,50,No,8,7,15,46
8,61,Yes,6,4,12,57
9,43,Yes,5,1,10,42
7,56,No,8,4,11,51
1,47,No,8,9,10,24
3,85,Yes,9,8,11,64
8,98,No,4,9,17,94
3,73,No,5,0,3,50
8,50,Yes,6,1,9,41
1,70,No,9,9,10,45
5,50,No,8,7,12,37
4,95,Yes,9,4,8,75
5,93,No,6,8,13,80
8,95,Yes,9,5,13,94
4,77,Yes,9,7,11,62
4,92,No,9,0,4,73
3,60,Yes,8,8,11,43
7,85,No,8,8,15,78
3,69,No,4,2,5,51
3,49,Yes,7,0,3,24
5,65,Yes,5,7,12,46
5,66,Yes,4,7,12,51
6,47,Yes,6,8,14,35
8,78,Yes,9,5,13,75
6,47,Yes,8,8,14,38
1,99,No,9,9,10,79
8,47,No,8,8,16,42
8,94,Yes,5,3,11,89
9,73,No,4,4,13,66
9,98,Yes,4,5,14,100
2,55,Yes,6,5,7,34
2,80,No,4,9,11,59
3,52,No,4,1,4,28
1,62,Yes,7,3,4,39
4,51,Yes,5,8,12,36
4,66,Yes,9,6,10,52
9,61,No,4,8,17,57
9,71,Yes,6,5,14,66
9,96,Yes,9,6,15,95
7,88,No,8,8,15,79
2,66,No,4,3,5,42
5,41,No,4,8,13,23
4,84,Yes,9,2,6,67
8,72,Yes,8,7,15,64
2,65,No,7,2,4,43
6,67,Yes,5,2,8,56
5,58,Yes,7,2,7,43
2,82,No,6,8,10,55
1,44,No,9,9,10,16
8,72,Yes,4,2,10,65
2,59,No,7,5,7,38
7,69,No,5,3,10,57
9,84,Yes,6,1,10,83
9,47,Yes,7,2,11,47
8,77,Yes,4,4,12,71
9,56,Yes,5,9,18,56
2,83,Yes,4,3,5,57
6,40,Yes,4,4,10,23
4,42,No,6,0,4,27
4,85,No,5,3,7,65
5,65,No,8,9,14,54
3,70,Yes,4,2,5,50
1,47,Yes,5,1,2,23
8,82,Yes,4,6,14,77
5,98,Yes,7,9,14,83
3,85,Yes,7,8,11,66
7,47,No,5,0,7,38
7,74,Yes,6,6,13,65
1,78,No,8,0,1,54
9,67,Yes,7,4,13,65
2,90,No,6,0,2,68
5,43,No,8,2,7,31
5,96,No,7,7,12,83
8,55,No,8,3,11,49
8,52,No,9,0,8,45
7,59,No,4,0,7,46
7,90,No,5,7,14,85
6,44,Yes,7,7,13,33
6,94,Yes,7,3,9,83
9,76,No,4,3,12,71
6,59,Yes,7,9,15,49
2,63,Yes,7,1,3,39
2,75,No,9,1,3,51
5,73,Yes,7,5,10,57
4,97,No,7,7,11,81
2,84,Yes,7,6,8,65
3,87,No,6,6,9,66
7,93,Yes,7,2,9,86
8,73,No,4,1,9,66
6,58,Yes,9,9,15,50
5,56,Yes,7,6,11,46
1,44,Yes,8,3,4,20
8,64,No,9,0,8,58
3,57,No,9,0,3,38
6,99,Yes,8,3,9,91
3,94,Yes,4,4,7,77
7,92,No,6,4,11,83
7,89,Yes,4,0,7,79
9,47,Yes,6,2,11,50
5,66,No,5,5,10,51
8,54,No,8,9,17,49
8,84,Yes,9,6,14,79
1,52,No,9,0,1,26
5,55,Yes,9,7,12,42
3,61,Yes,8,3,6,42
1,59,No,8,8,9,35
4,52,Yes,6,5,9,31
8,59,No,9,0,8,50
3,41,No,4,1,4,18
2,74,Yes,6,2,4,50
9,86,No,9,1,10,82
5,94,Yes,8,9,14,78
7,58,No,8,6,13,53
2,84,Yes,8,0,2,65
9,76,No,9,8,17,76
9,97,Yes,8,1,10,94
4,93,Yes,5,3,7,79
4,45,No,8,7,11,27
6,53,Yes,9,2,8,43
6,43,Yes,6,8,14,30
1,61,Yes,8,6,7,37
9,90,Yes,7,9,18,90
2,94,Yes,5,2,4,68
5,78,Yes,9,2,7,64
9,75,No,8,4,13,73
4,73,No,7,4,8,53
3,66,No,9,9,12,46
7,46,No,6,4,11,37
6,42,Yes,5,8,14,29
8,86,Yes,8,8,16,80
3,72,No,6,5,8,52
5,41,Yes,9,6,11,29
4,81,No,7,9,13,70
4,55,Yes,9,7,11,40
4,64,Yes,9,8,12,49
8,99,No,5,5,13,92
6,54,Yes,8,7,13,46
3,63,No,6,1,4,42
5,54,No,5,9,14,41
6,70,No,7,7,13,60
5,53,Yes,8,1,6,41
6,93,Yes,5,7,13,83
8,53,No,7,1,9,43
7,45,Yes,7,2,9,36
5,53,No,6,6,11,38
6,56,No,9,8,14,47
4,57,Yes,7,2,6,40
9,59,No,7,4,13,59
4,90,Yes,9,8,12,76
1,56,Yes,4,6,7,31
7,55,Yes,7,1,8,44
7,79,No,8,4,11,71
4,78,No,5,4,8,59
3,91,Yes,9,8,11,69
8,71,Yes,9,1,9,63
5,99,No,9,0,5,87
7,83,Yes,8,3,10,77
4,48,Yes,9,3,7,31
4,66,No,8,0,4,47
8,85,No,6,9,17,78
8,91,No,4,6,14,86
2,72,Yes,9,1,3,48
2,49,No,4,8,10,24
3,56,No,9,6,9,39
3,88,No,8,6,9,71
1,88,No,5,0,1,60
3,75,No,4,8,11,54
6,56,No,4,9,15,45
8,57,No,8,8,16,51
6,91,Yes,4,1,7,78
5,62,No,6,9,14,48
4,73,Yes,8,8,12,59
3,47,Yes,4,1,4,28
4,52,No,4,1,5,35
7,62,Yes,4,7,14,55
1,96,No,8,2,3,69
7,93,Yes,5,2,9,87
1,59,No,7,6,7,32
2,61,Yes,9,9,11,37
4,86,No,4,5,9,66
1,91,No,7,6,7,66
9,62,Yes,7,5,14,56
6,80,Yes,4,8,14,70
1,74,No,4,1,2,48
1,42,Yes,9,7,8,17
6,73,No,7,5,11,59
4,72,Yes,5,3,7,56
4,85,No,7,5,9,66
6,56,Yes,5,5,11,41
7,84,No,6,9,16,76
9,58,Yes,5,2,11,54
5,69,No,9,7,12,57
9,62,Yes,8,4,13,62
4,54,No,4,9,13,38
2,98,Yes,6,3,5,73
3,96,Yes,7,1,4,72
1,53,No,5,9,10,28
6,41,Yes,6,0,6,28
6,78,Yes,8,6,12,67
1,88,No,5,9,10,62
3,57,No,9,2,5,36
5,45,No,7,2,7,33
3,98,No,7,2,5,74
3,71,Yes,5,9,12,52
3,60,Yes,8,2,5,38
5,79,Yes,4,1,6,62
5,67,No,4,5,10,50
4,66,Yes,7,9,13,48
1,41,Yes,8,2,3,15
5,72,No,7,0,5,51
5,55,Yes,4,9,14,37
4,78,Yes,7,8,12,59
6,61,No,5,5,11,46
4,95,Yes,9,5,9,78
7,82,No,5,9,16,74
7,86,No,9,8,15,78
2,52,Yes,8,1,3,27
3,95,Yes,4,9,12,74
1,41,Yes,8,8,9,15
8,53,No,8,2,10,46
9,95,No,4,2,11,90
4,77,Yes,6,2,6,58
6,80,Yes,6,0,6,65
9,67,No,7,9,18,65
6,46,Yes,6,6,12,36
9,57,Yes,5,9,18,52
4,95,No,9,6,10,79
8,80,Yes,8,1,9,74
9,94,Yes,7,5,14,93
4,75,Yes,8,3,7,57
5,80,Yes,4,6,11,65
8,75,No,6,6,14,69
6,83,No,4,3,9,71
7,43,No,7,2,9,31
3,96,No,9,6,9,78
7,69,Yes,5,8,15,60
8,63,Yes,6,3,11,58
6,59,Yes,4,5,11,46
9,85,Yes,9,6,15,87
6,95,No,6,9,15,81
9,70,Yes,8,2,11,69
4,63,Yes,5,4,8,46
8,46,No,9,0,8,41
4,65,No,6,5,9,50
2,52,No,5,4,6,24
9,93,Yes,9,6,15,97
5,47,No,8,8,13,35
4,94,Yes,8,3,7,82
2,44,Yes,4,8,10,24
1,83,No,7,5,6,59
7,52,No,4,4,11,42
6,68,No,5,1,7,56
2,59,Yes,4,0,2,30
8,53,Yes,9,7,15,49
4,71,Yes,6,5,9,56
8,99,No,9,6,14,98
7,89,Yes,4,5,12,79
5,66,Yes,7,9,14,54
8,95,Yes,9,6,14,93
9,64,Yes,9,8,17,63
5,91,No,9,4,9,76
5,43,Yes,7,0,5,27
2,60,No,9,0,2,35
5,57,No,5,8,13,39
3,78,Yes,8,4,7,59
7,54,Yes,7,1,8,50
5,92,No,5,2,7,77
8,77,Yes,7,0,8,70
1,87,No,7,5,6,62
3,91,Yes,8,5,8,71
3,63,Yes,6,2,5,39
9,47,No,5,2,11,41
5,67,Yes,7,6,11,51
9,60,No,7,0,9,52
9,55,No,4,4,13,49
1,99,Yes,9,2,3,76
2,93,No,6,4,6,71
5,55,Yes,8,3,8,42
4,74,Yes,5,5,9,60
9,56,Yes,7,8,17,53
7,48,No,9,1,8,40
6,96,Yes,5,9,15,85
7,74,Yes,8,7,14,70
1,91,No,6,1,2,63
1,68,No,4,3,4,42
8,78,No,6,8,16,73
2,57,No,4,3,5,35
9,51,Yes,5,6,15,48
7,58,Yes,6,4,11,49
6,87,Yes,6,1,7,75
1,61,Yes,6,7,8,35
1,98,No,8,9,10,70
2,95,No,5,9,11,71
6,88,Yes,4,1,7,74
6,91,No,6,2,8,77
2,54,No,5,9,11,30
1,40,No,9,6,7,13
5,41,No,8,4,9,26
5,47,No,8,9,14,35
2,61,Yes,9,2,4,40
6,64,Yes,5,1,7,55
9,41,No,4,5,14,37
2,90,No,5,9,11,64
2,48,Yes,5,0,2,23
3,48,Yes,7,7,10,27
7,52,No,8,4,11,42
6,45,No,4,4,10,34
8,69,No,7,1,9,63
8,54,Yes,9,6,14,50
6,90,No,5,4,10,75
3,92,No,9,7,10,74
3,54,No,8,4,7,39
1,89,No,7,8,9,63
7,46,No,7,4,11,36
5,97,No,4,2,7,84
4,50,No,5,1,5,30
4,79,No,4,4,8,60
4,77,Yes,7,9,13,61
6,79,Yes,7,9,15,70
8,41,Yes,4,4,12,32
8,90,No,7,5,13,87
5,87,Yes,6,1,6,72
6,78,Yes,8,4,10,68
4,49,Yes,5,0,4,29
9,83,Yes,8,2,11,78
8,56,Yes,5,2,10,45
1,46,No,7,2,3,20
2,93,Yes,4,2,4,66
9,79,No,4,7,16,77
8,78,No,7,0,8,72
3,43,Yes,5,5,8,26
8,74,No,7,5,13,67
1,90,Yes,5,0,1,67
4,86,No,7,0,4,68
3,75,No,7,2,5,56
6,70,Yes,7,7,13,61
7,64,No,4,5,12,50
4,80,No,5,3,7,68
7,52,No,9,4,11,47
9,57,No,7,9,18,56
2,60,No,8,2,4,40
3,87,No,8,5,8,68
5,40,No,4,5,10,26
3,75,No,6,5,8,55
8,89,Yes,9,8,16,84
8,47,No,4,9,17,40
8,91,Yes,6,7,15,85
9,87,Yes,4,5,14,85
4,60,No,8,1,5,40
5,82,No,7,3,8,68
5,91,Yes,5,5,10,74
8,92,Yes,7,8,16,90
7,92,Yes,8,1,8,82
9,60,No,5,5,14,57
8,66,No,6,9,17,61
2,58,No,6,9,11,38
4,62,Yes,8,9,13,46
6,90,No,5,6,12,80
2,89,No,7,7,9,67
7,90,No,8,8,15,84
3,82,No,6,4,7,58
3,74,Yes,8,8,11,55
2,79,No,7,8,10,57
8,91,No,4,6,14,87
6,90,Yes,9,1,7,80
1,81,No,9,7,8,54
1,87,Yes,9,4,5,64
7,44,Yes,4,7,14,33
8,91,No,7,1,9,83
5,80,Yes,5,6,11,66
5,47,No,8,4,9,33
4,50,Yes,7,3,7,31
6,55,Yes,4,9,15,40
6,78,No,6,5,11,66
3,86,Yes,9,4,7,67
9,63,No,9,5,14,64
7,60,No,7,8,15,52
1,91,No,9,0,1,68
7,62,No,9,0,7,58
5,88,Yes,7,5,10,72
5,77,No,7,1,6,65
2,86,Yes,4,7,9,65
4,47,No,4,6,10,24
6,46,Yes,9,5,11,35
7,41,Yes,7,3,10,34
5,69,Yes,7,8,13,57
9,52,Yes,9,6,15,54
3,62,No,5,6,9,42
1,68,No,6,4,5,39
4,77,Yes,8,0,4,62
9,76,Yes,8,1,10,71
4,59,No,9,7,11,42
2,72,Yes,8,4,6,52
5,68,Yes,4,1,6,54
3,89,No,4,4,7,68
9,54,Yes,5,7,16,50
4,62,Yes,9,3,7,46
6,81,No,4,2,8,68
2,42,Yes,9,4,6,19
6,76,No,9,6,12,68
3,95,No,7,1,4,74
9,68,No,6,0,9,63
2,84,No,6,4,6,60
9,47,Yes,9,6,15,47
5,61,No,6,7,12,47
8,92,No,6,7,15,87
2,68,Yes,8,9,11,45
6,41,No,8,8,14,31
3,80,Yes,7,0,3,61
5,88,No,5,6,11,73
8,98,No,4,9,17,92
1,89,No,4,7,8,65
5,84,No,8,5,10,69
3,40,Yes,9,9,12,20
4,83,Yes,6,3,7,66
2,59,Yes,7,6,8,38
9,91,No,5,2,11,81
3,60,No,8,1,4,39
2,76,No,9,5,7,53
9,47,Yes,7,1,10,44
7,66,No,9,5,12,58
6,86,Yes,7,9,15,79
1,98,Yes,8,2,3,75
5,74,Yes,7,1,6,59
3,45,No,6,7,10,23
1,99,No,7,3,4,74
4,84,No,5,3,7,65
2,83,No,7,6,8,60
2,58,Yes,4,7,9,32
3,57,Yes,7,8,11,38
8,95,No,9,9,17,91
8,40,No,8,7,15,34
7,64,No,4,3,10,46
6,66,Yes,8,1,7,55
9,46,No,9,9,18,43
4,83,Yes,5,4,8,67
1,81,Yes,6,6,7,56
8,68,Yes,5,1,9,58
7,70,Yes,4,3,10,60
7,83,Yes,9,5,12,77
3,82,Yes,9,7,10,69
4,75,Yes,6,9,13,60
9,58,No,7,5,14,52
6,45,No,4,5,11,36
5,64,No,6,5,10,49
3,70,Yes,8,3,6,50
9,48,Yes,6,2,11,48
5,59,No,8,0,5,43
5,49,Yes,8,1,6,34
4,76,Yes,9,1,5,57
4,66,Yes,6,9,13,50
1,52,Yes,9,6,7,28
7,80,Yes,9,5,12,72
9,41,Yes,5,7,16,38
3,89,Yes,5,8,11,68
2,60,Yes,9,4,6,41
3,72,Yes,9,2,5,53
1,63,Yes,8,3,4,36
6,92,Yes,9,7,13,80
7,83,Yes,4,2,9,73
2,81,No,6,1,3,59
8,73,Yes,4,6,14,67
6,99,Yes,5,3,9,91
4,48,No,4,7,11,34
5,41,No,7,0,5,23
8,94,No,7,7,15,86
3,95,Yes,5,4,7,73
3,69,Yes,4,1,4,49
4,61,No,6,0,4,43
1,85,No,5,5,6,61
9,50,No,7,8,17,45
8,94,Yes,5,8,16,85
8,82,Yes,4,8,16,75
6,56,No,4,3,9,44
7,75,Yes,4,5,12,66
6,52,Yes,8,9,15,45
9,46,No,4,5,14,40
3,55,No,9,4,7,38
3,72,No,7,1,4,50
3,84,Yes,7,6,9,67
3,40,Yes,8,0,3,21
9,50,Yes,7,5,14,51
4,45,Yes,7,4,8,25
7,59,Yes,5,4,11,53
9,74,No,4,7,16,71
7,83,Yes,9,8,15,77
9,76,Yes,9,6,15,75
3,80,No,5,9,12,60
4,65,No,9,7,11,49
8,97,No,5,1,9,87
6,51,No,9,1,7,40
5,69,Yes,7,7,12,56
4,67,Yes,6,5,9,49
8,66,No,4,7,15,59
1,81,Yes,6,8,9,59
9,58,No,7,8,17,54
1,44,Yes,8,5,6,17
8,97,Yes,5,7,15,90
4,44,Yes,9,1,5,23
9,80,No,9,7,16,82
5,66,No,7,2,7,49
3,67,Yes,9,0,3,50
9,65,Yes,7,6,15,60
9,66,No,6,0,9,60
4,91,No,8,0,4,74
4,88,Yes,5,0,4,71
8,81,Yes,9,3,11,77
2,60,No,8,3,5,34
9,40,Yes,8,9,18,39
6,93,No,8,5,11,85
9,67,No,4,9,18,64
8,87,Yes,8,2,10,87
7,97,Yes,7,9,16,91
1,97,Yes,4,5,6,73
3,54,No,4,6,9,34
2,94,No,8,0,2,70
5,56,No,9,5,10,42
5,65,Yes,9,9,14,55
5,59,Yes,9,0,5,45
4,64,No,9,6,10,49
5,52,No,7,9,14,37
3,72,Yes,9,4,7,55
1,64,No,5,9,10,38
5,47,Yes,8,3,8,35
9,44,Yes,4,0,9,41
9,45,No,5,8,17,43
4,62,No,9,6,10,46
3,91,No,5,1,4,69
1,69,No,4,3,4,37
2,53,No,9,3,5,31
8,93,Yes,5,7,15,90
1,62,No,7,1,2,33
8,50,Yes,7,4,12,44
7,70,No,8,9,16,62
8,45,No,8,7,15,41
6,50,No,5,5,11,38
9,52,No,4,3,12,45
3,51,No,7,4,7,34
4,93,No,6,1,5,72
6,41,Yes,8,4,10,29
8,92,No,7,2,10,83
5,74,No,9,2,7,61
3,94,No,5,6,9,75
6,75,No,7,2,8,63
4,56,Yes,7,3,7,36
9,67,Yes,5,6,15,62
3,67,Yes,8,2,5,49
4,61,Yes,8,9,13,46
7,77,Yes,6,9,16,69
7,46,Yes,6,1,8,35
4,54,No,8,9,13,38
6,71,No,8,6,12,62
3,50,Yes,8,4,7,30
6,63,No,8,0,6,52
2,42,No,7,9,11,16
8,69,No,6,7,15,66
2,45,No,5,2,4,20
7,97,No,4,6,13,86
9,41,Yes,5,5,14,38
1,53,Yes,9,9,10,30
8,80,Yes,4,5,13,71
7,57,Yes,7,7,14,49
6,90,Yes,9,3,9,79
6,83,Yes,6,3,9,69
6,70,No,4,2,8,56
9,52,Yes,8,0,9,47
2,65,No,9,9,11,41
1,83,No,7,2,3,58
6,51,Yes,4,0,6,38
8,57,Yes,8,5,13,52
3,48,Yes,9,7,10,25
1,88,No,7,2,3,62
9,60,Yes,9,3,12,60
1,87,Yes,4,4,5,63
3,88,Yes,8,6,9,72
8,92,No,6,5,13,84
3,95,Yes,7,1,4,74
4,79,Yes,4,6,10,61
8,82,No,8,7,15,77
1,63,No,6,0,1,36
6,73,No,9,5,11,65
1,47,Yes,8,8,9,23
1,83,Yes,6,6,7,60
8,92,No,4,4,12,83
4,72,Yes,8,9,13,56
1,62,No,8,9,10,37
7,52,No,5,8,15,43
5,93,No,7,1,6,76
5,92,No,8,6,11,83
1,88,No,6,8,9,63
6,53,Yes,7,1,7,39
9,53,Yes,4,9,18,48
9,55,Yes,7,5,14,53
8,88,Yes,5,8,16,84
5,77,No,4,2,7,63
1,97,Yes,8,7,8,73
9,99,No,9,4,13,99
1,78,No,4,6,7,52
8,65,Yes,4,2,10,58
5,65,Yes,5,7,12,50
3,40,No,6,1,4,18
7,71,Yes,4,7,14,62
7,96,Yes,6,1,8,87
9,54,Yes,7,6,15,53
7,91,Yes,9,1,8,87
3,60,No,5,6,9,37
1,57,No,8,0,1,31
8,69,Yes,4,5,13,63
3,99,No,9,9,12,81
8,97,No,9,6,14,95
8,52,Yes,6,3,11,45
5,63,Yes,4,0,5,48
1,69,No,9,5,6,47
7,41,No,5,3,10,31
5,58,No,8,2,7,43
8,86,Yes,7,3,11,82
9,83,No,7,5,14,80
7,86,No,6,4,11,76
7,64,Yes,9,1,8,57
1,89,No,7,1,2,64
4,53,Yes,6,2,6,35
2,45,Yes,8,5,7,24
2,51,No,4,0,2,30
2,59,Yes,5,6,8,38
4,62,Yes,8,7,11,45
1,69,No,8,6,7,44
4,69,Yes,7,2,6,53
2,77,No,7,5,7,53
5,97,Yes,5,3,8,84
3,69,Yes,4,4,7,47
8,80,No,8,2,10,76
4,69,No,9,4,8,57
1,96,No,7,5,6,71
1,97,Yes,8,7,8,74
3,75,No,4,5,8,54
9,88,Yes,6,8,17,84
7,73,No,4,9,16,62
2,55,Yes,8,9,11,35
9,63,No,8,9,18,62
2,53,Yes,5,9,11,30
3,65,No,8,3,6,47
2,47,Yes,7,1,3,25
3,53,Yes,9,8,11,40
6,70,Yes,5,2,8,56
9,41,Yes,8,6,15,38
9,87,No,4,3,12,86
7,43,Yes,8,0,7,38
3,40,No,4,7,10,17
4,94,Yes,4,3,7,75
6,59,No,8,5,11,48
5,98,Yes,4,6,11,87
2,53,Yes,9,7,9,32
6,79,No,6,9,15,68
3,64,No,5,1,4,42
8,99,Yes,8,8,16,96
2,64,No,6,9,11,42
1,42,No,4,2,3,18
9,44,No,4,0,9,41
3,77,Yes,5,1,4,54
1,93,No,6,7,8,67
7,65,Yes,6,9,16,57
5,79,No,8,5,10,65
5,77,No,4,0,5,62
1,77,Yes,7,8,9,56
9,43,No,8,6,15,39
7,46,No,8,9,16,38
8,69,No,8,2,10,65
9,69,No,5,6,15,68
6,95,No,5,5,11,82
5,58,No,8,2,7,44
6,78,No,9,7,13,67
2,74,Yes,7,0,2,53
4,79,Yes,6,4,8,61
3,72,Yes,6,7,10,53
7,72,Yes,4,2,9,61
9,53,Yes,6,9,18,49
5,77,No,6,5,10,61
6,49,Yes,7,9,15,38
2,96,Yes,6,1,3,76
3,67,No,7,8,11,47
3,53,Yes,5,1,4,32
9,75,No,7,4,13,71
7,77,No,5,2,9,69
8,55,Yes,7,9,17,53
9,99,Yes,8,8,17,100
6,60,No,9,8,14,49
4,67,No,5,6,10,48
1,72,Yes,5,9,10,45
8,45,No,6,4,12,40
7,80,Yes,5,8,15,71
2,54,Yes,7,6,8,34
8,83,Yes,8,1,9,76
5,42,Yes,8,9,14,29
7,82,No,6,0,7,71
4,86,No,7,9,13,69
5,74,Yes,7,9,14,58
8,53,Yes,4,3,11,43
1,41,No,5,9,10,17
1,68,No,6,7,8,41
4,43,No,8,5,9,27
3,65,No,9,1,4,45
2,90,No,4,4,6,65
3,51,Yes,7,8,11,31
1,41,Yes,5,5,6,14
1,56,Yes,8,5,6,33
6,74,Yes,4,6,12,60
5,49,No,7,4,9,34
8,87,No,8,2,10,82
2,61,Yes,8,2,4,40
4,80,Yes,7,4,8,66
8,82,No,7,3,11,76
6,60,Yes,6,4,10,46
1,54,Yes,8,8,9,31
4,74,No,7,4,8,57
1,87,No,9,3,4,65
2,60,No,9,3,5,38
5,60,Yes,4,0,5,46
8,60,No,5,9,17,53
8,99,No,9,3,11,97
3,83,Yes,6,3,6,63
4,71,No,7,8,12,55
6,94,Yes,5,3,9,79
3,44,Yes,6,6,9,26
2,78,Yes,8,0,2,55
6,48,Yes,5,6,12,37
5,92,No,9,1,6,78
5,57,Yes,6,7,12,45
5,60,No,7,0,5,45
5,47,No,7,9,14,34
3,83,No,6,2,5,66
7,91,No,8,7,14,79
6,73,No,9,9,15,63
4,49,Yes,6,7,11,32
2,90,No,4,4,6,64
9,80,Yes,6,4,13,78
1,96,Yes,6,7,8,69
4,63,Yes,9,9,13,46
1,79,No,7,4,5,54
6,63,No,8,8,14,51
4,95,No,6,0,4,78
5,71,No,5,4,9,54
5,95,Yes,7,2,7,80
9,72,No,7,2,11,67
1,77,No,6,1,2,48
2,83,Yes,9,2,4,61
6,96,Yes,5,6,12,83
5,95,Yes,6,7,12,82
7,90,Yes,5,7,14,78
3,98,Yes,7,7,10,78
3,88,Yes,5,0,3,70
2,73,Yes,6,6,8,48
3,50,No,4,1,4,26
1,70,No,4,9,10,46
5,57,Yes,5,3,8,42
5,62,Yes,9,4,9,46
7,99,No,6,0,7,91
4,61,Yes,8,3,7,47
3,82,Yes,4,3,6,61
1,57,Yes,7,8,9,31
8,79,Yes,6,8,16,71
3,86,Yes,6,9,12,66
2,80,No,4,0,2,52
4,86,Yes,8,7,11,71
3,78,Yes,7,3,6,60
1,59,Yes,8,3,4,32
3,52,No,7,4,7,33
2,84,No,4,1,3,56
8,40,Yes,6,0,8,32
6,91,Yes,7,4,10,76
9,43,Yes,6,6,15,40
8,63,Yes,5,9,17,60
3,75,No,5,8,11,54
5,75,No,4,1,6,59
7,84,Yes,4,7,14,74
5,41,Yes,9,6,11,29
8,67,No,4,1,9,61
5,65,No,5,4,9,50
1,62,Yes,7,6,7,36
5,54,Yes,8,2,7,41
4,75,Yes,4,1,5,60
6,66,No,8,5,11,56
3,45,No,8,9,12,23
5,74,No,5,5,10,63
2,78,No,9,3,5,54
6,77,Yes,7,0,6,64
6,74,No,5,4,10,64
5,75,No,4,0,5,58
6,49,No,5,7,13,38
7,69,Yes,5,1,8,60
5,92,No,5,8,13,79
1,80,No,4,8,9,57
8,77,No,4,2,10,69
4,68,Yes,5,5,9,51
9,91,No,5,8,17,86
6,98,Yes,8,6,12,90
1,82,Yes,7,3,4,57
3,78,No,8,2,5,61
3,89,Yes,9,1,4,71
4,43,No,7,9,13,30
6,44,Yes,9,9,15,34
7,43,Yes,7,0,7,34
4,75,No,5,9,13,58
6,98,No,8,0,6,85
1,84,Yes,7,3,4,55
8,55,Yes,9,3,11,51
7,64,Yes,7,8,15,53
9,53,Yes,4,9,18,51
3,50,No,7,0,3,31
2,68,Yes,5,3,5,44
1,73,Yes,6,2,3,48
3,61,No,4,8,11,41
5,53,Yes,6,4,9,40
2,95,No,5,8,10,72
3,63,No,6,9,12,41
4,98,No,7,5,9,78
7,78,Yes,6,8,15,70
3,65,No,8,0,3,41
9,82,No,5,3,12,78
8,75,No,8,3,11,70
4,78,Yes,6,9,13,61
1,55,Yes,8,9,10,33
1,97,Yes,4,5,6,71
1,77,Yes,6,9,10,51
1,98,No,9,0,1,72
8,71,No,8,9,17,69
3,45,No,7,4,7,21
6,73,Yes,6,2,8,61
3,95,No,9,0,3,76
5,47,Yes,4,5,10,30
7,69,Yes,7,2,9,59
2,66,Yes,6,3,5,45
6,46,No,7,8,14,39
6,66,No,6,1,7,53
3,64,Yes,6,0,3,43
6,95,No,5,9,15,85
5,85,Yes,8,5,10,70
2,80,No,6,0,2,56
9,54,Yes,4,0,9,52
8,64,Yes,9,6,14,65
3,61,Yes,8,1,4,39
8,57,No,5,3,11,48
9,51,No,8,3,12,47
3,62,No,8,1,4,41
3,90,No,6,5,8,72
2,84,No,4,9,11,61
8,78,Yes,6,1,9,74
1,64,No,4,7,8,38
8,49,Yes,4,3,11,42
7,69,No,7,0,7,60
7,49,No,6,6,13,35
3,73,No,5,5,8,52
1,85,Yes,9,5,6,61
4,52,No,8,2,6,32
9,93,Yes,7,9,18,95
5,68,No,5,6,11,53
1,77,Yes,9,5,6,54
5,80,Yes,9,9,14,70
8,84,Yes,6,9,17,78
8,48,Yes,4,8,16,42
5,52,No,6,2,7,33
9,76,No,9,2,11,75
1,53,Yes,6,3,4,26
4,76,No,7,2,6,58
3,48,Yes,5,3,6,29
2,47,No,9,5,7,29
8,78,No,7,0,8,70
7,79,No,5,1,8,67
9,93,Yes,7,9,18,93
2,42,No,8,5,7,21
4,94,Yes,4,5,9,74
6,95,No,4,0,6,82
3,86,Yes,4,5,8,65
8,79,No,8,8,16,75
3,72,Yes,9,7,10,55
2,71,Yes,9,9,11,54
3,46,Yes,8,4,7,26
6,58,No,4,3,9,48
2,73,Yes,4,5,7,49
8,53,No,5,4,12,49
1,89,Yes,5,5,6,64
7,86,Yes,6,9,16,81
2,85,Yes,7,2,4,64
6,95,No,5,6,12,82
2,96,No,5,7,9,74
2,58,No,5,4,6,32
8,90,No,5,4,12,83
2,93,No,8,3,5,68
7,98,No,6,9,16,90
3,65,No,5,4,7,44
8,56,Yes,9,9,17,51
7,93,Yes,7,7,14,86
8,67,No,5,4,12,62
7,58,No,8,8,15,48
6,66,No,9,0,6,56
7,87,No,4,6,13,79
5,91,No,4,4,9,74
7,96,Yes,6,3,10,82
1,58,No,4,2,3,32
1,72,No,5,9,10,46
9,90,No,8,6,15,88
5,46,Yes,6,1,6,35
5,68,Yes,9,4,9,56
3,94,Yes,5,1,4,74
5,82,Yes,4,6,11,67
3,44,No,7,5,8,23
9,69,Yes,5,9,18,67
9,88,Yes,7,6,15,86
6,82,Yes,9,8,14,70
1,95,Yes,7,1,2,68
7,97,Yes,9,8,15,91
7,47,No,6,6,13,42
4,81,Yes,8,1,5,62
8,51,Yes,4,9,17,44
6,81,Yes,4,1,7,67
4,52,No,5,3,7,35
4,65,No,4,1,5,46
2,57,No,6,0,2,31
2,81,No,4,5,7,59
4,90,No,5,9,13,71
5,91,No,4,4,9,74
8,88,No,8,2,10,80
6,59,No,9,0,6,49
4,55,Yes,7,8,12,39
7,76,Yes,7,7,14,67
8,42,No,9,5,13,38
2,66,Yes,7,5,7,47
7,54,No,8,3,10,41
2,97,Yes,6,1,3,75
2,73,Yes,5,3,5,53
8,84,No,8,1,9,81
2,61,Yes,5,6,8,37
9,79,No,6,8,17,77
1,62,No,8,1,2,36
9,98,Yes,4,8,17,95
1,88,No,6,8,9,65
2,43,Yes,7,7,9,18
6,90,Yes,8,0,6,80
6,93,No,6,4,10,81
1,96,No,6,9,10,73
7,80,No,8,3,10,74
8,62,No,7,6,14,57
2,86,No,9,7,9,64
8,99,Yes,7,9,17,97
9,48,No,6,7,16,42
6,63,Yes,5,1,7,48
5,60,No,9,2,7,46
9,80,Yes,9,9,18,79
9,85,Yes,6,9,18,83
1,94,Yes,8,6,7,70
3,92,Yes,8,3,6,73
9,55,Yes,8,5,14,56
2,95,No,7,7,9,71
4,94,Yes,4,7,11,76
4,64,No,8,6,10,49
2,65,Yes,8,1,3,43
3,88,No,9,1,4,67
3,84,Yes,5,2,5,63
1,48,Yes,5,3,4,18
6,54,No,6,0,6,43
8,78,No,6,4,12,72
3,72,Yes,6,6,9,57
5,40,Yes,8,9,14,25
1,44,No,5,4,5,15
7,95,Yes,6,6,13,88
1,48,Yes,5,4,5,24
9,83,No,8,9,18,81
8,45,Yes,9,7,15,40
7,67,Yes,8,6,13,60
7,84,No,6,0,7,73
5,65,Yes,8,0,5,52
5,67,No,8,4,9,53
5,79,No,5,1,6,65
1,54,Yes,4,8,9,30
8,45,Yes,7,1,9,39
1,66,No,6,8,9,43
4,77,No,4,9,13,59
9,43,Yes,9,1,10,38
9,50,No,6,3,12,44
5,60,Yes,4,2,7,44
4,69,No,8,5,9,53
3,57,No,6,3,6,37
3,74,No,4,8,11,52
5,42,Yes,7,8,13,30
1,51,No,8,9,10,22
5,66,No,6,8,13,51
6,92,No,9,2,8,82
7,69,No,9,2,9,63
9,60,Yes,6,3,12,58
3,77,No,4,8,11,58
2,60,Yes,6,5,7,38
3,99,No,8,8,11,80
9,77,No,5,7,16,70
7,79,Yes,9,6,13,72
9,54,Yes,4,4,13,48
2,57,No,7,8,10,36
5,91,No,6,3,8,73
4,68,No,8,3,7,51
2,87,Yes,6,7,9,63
9,77,No,7,3,12,74
9,99,Yes,8,6,15,98
6,60,No,7,3,9,45
6,56,Yes,8,0,6,45
8,80,Yes,5,9,17,74
6,90,Yes,9,8,14,81
1,57,No,8,3,4,30
4,96,No,7,2,6,77
7,94,Yes,4,2,9,86
2,76,Yes,9,8,10,58
9,99,Yes,5,7,16,99
8,77,No,6,9,17,69
8,51,No,5,6,14,47
7,50,No,5,6,13,42
4,87,Yes,6,3,7,73
2,91,No,8,2,4,71
3,88,No,5,3,6,68
6,59,No,9,5,11,47
5,48,Yes,5,3,8,31
8,40,No,4,3,11,31
6,97,No,9,1,7,86
6,42,No,4,6,12,27
1,60,No,9,5,6,32
4,62,No,7,1,5,41
5,48,Yes,6,4,9,33
3,93,Yes,9,5,8,75
9,58,Yes,9,4,13,57
1,84,Yes,8,3,4,59
6,94,No,8,8,14,87
6,85,No,7,2,8,72
5,91,Yes,8,1,6,78
5,58,Yes,8,8,13,46
5,62,Yes,4,7,12,47
6,66,No,8,8,14,58
8,66,No,8,9,17,63
2,78,No,7,2,4,56
6,75,Yes,7,0,6,62
1,51,Yes,5,0,1,23
4,94,Yes,8,2,6,73
3,66,No,8,3,6,46
9,85,No,9,1,10,80
3,73,Yes,8,7,10,59
6,72,Yes,4,2,8,60
1,67,No,9,3,4,41
6,70,No,8,5,11,61
4,71,Yes,4,9,13,51
8,89,Yes,5,5,13,82
9,59,No,9,1,10,55
4,79,Yes,6,5,9,64
6,74,Yes,8,3,9,61
1,70,No,9,4,5,44
4,97,Yes,7,6,10,81
7,70,No,9,6,13,64
1,77,Yes,7,5,6,53
8,61,No,8,9,17,55
6,84,Yes,4,5,11,72
5,80,Yes,7,5,10,65
9,48,Yes,9,3,12,44
2,91,No,9,2,4,70
5,48,Yes,7,0,5,34
6,54,Yes,5,2,8,41
7,52,No,5,2,9,43
5,61,Yes,5,8,13,48
9,55,No,7,2,11,46
1,71,No,7,7,8,47
7,41,No,9,7,14,37
7,65,Yes,8,2,9,56
4,53,No,8,9,13,40
9,98,Yes,4,9,18,96
5,77,No,7,5,10,63
4,73,Yes,8,7,11,58
7,47,No,8,7,14,36
4,75,No,5,9,13,61
3,60,Yes,5,9,12,39
9,95,No,5,8,17,90
8,85,Yes,6,8,16,79
1,82,No,8,7,8,58
7,95,Yes,5,6,13,89
9,67,No,5,9,18,64
8,85,No,7,2,10,78
8,83,Yes,9,6,14,79
6,87,No,5,3,9,72
4,45,Yes,7,1,5,26
8,59,Yes,4,7,15,52
3,70,No,5,1,4,49
9,72,No,9,0,9,66
2,83,No,7,4,6,59
2,46,Yes,9,9,11,28
7,47,Yes,5,8,15,39
4,48,No,4,4,8,31
8,41,Yes,5,1,9,33
9,56,No,7,9,18,57
7,91,No,4,3,10,83
5,84,No,4,7,12,69
8,76,Yes,4,6,14,71
4,81,Yes,6,4,8,62
2,83,No,7,3,5,58
6,56,Yes,6,4,10,46
9,92,No,9,6,15,93
1,77,No,4,4,5,48
7,74,Yes,6,7,14,68
9,99,No,5,6,15,97
9,86,No,6,6,15,82
3,78,No,8,8,11,57
5,69,No,9,7,12,55
8,45,No,4,7,15,37
8,43,Yes,4,5,13,35
4,90,Yes,9,6,10,72
1,76,No,9,7,8,51
1,74,Yes,7,4,5,50
4,97,No,5,9,13,82
6,96,No,9,1,7,84
8,48,No,9,6,14,46
6,45,No,7,9,15,34
9,52,Yes,9,2,11,55
9,98,Yes,6,9,18,95
2,61,No,8,7,9,40
1,67,Yes,8,5,6,42
2,69,No,8,3,5,45
5,91,Yes,9,1,6,80
4,75,No,8,6,10,60
4,41,No,5,0,4,21
9,97,No,6,6,15,95
8,75,Yes,8,9,17,72
6,47,Yes,4,9,15,35
1,84,No,9,6,7,58
2,81,Yes,6,9,11,59
6,89,Yes,5,2,8,77
2,48,Yes,8,3,5,23
5,40,Yes,5,3,8,26
5,52,Yes,9,3,8,39
6,89,Yes,8,8,14,79
6,54,Yes,4,5,11,39
6,71,Yes,6,9,15,61
2,73,Yes,4,8,10,47
3,82,Yes,8,3,6,63
6,70,Yes,7,6,12,61
8,53,Yes,6,9,17,51
1,93,Yes,5,8,9,68
1,86,No,8,9,10,66
2,53,No,4,2,4,29
6,87,Yes,9,2,8,78
9,94,Yes,7,5,14,94
4,68,Yes,9,7,11,56
3,86,No,8,0,3,68
8,58,No,5,3,11,50
9,66,Yes,4,7,16,62
5,48,Yes,6,5,10,31
9,76,Yes,7,1,10,73
2,76,Yes,8,7,9,57
3,82,Yes,8,0,3,60
7,67,No,8,0,7,56
7,91,Yes,8,6,13,88
6,96,No,4,9,15,84
6,63,Yes,6,2,8,48
2,67,Yes,5,7,9,41
6,75,No,7,8,14,65
4,91,No,8,7,11,74
3,57,Yes,9,0,3,38
2,64,No,8,0,2,40
1,74,Yes,6,5,6,49
5,43,No,6,0,5,30
2,53,No,4,7,9,29
2,78,Yes,4,5,7,57
7,65,Yes,9,4,11,58
8,47,No,9,5,13,40
8,63,Yes,4,3,11,60
4,55,No,7,0,4,41
1,59,No,9,6,7,34
7,54,Yes,4,9,16,46
1,46,No,8,8,9,24
4,97,Yes,4,3,7,79
8,56,Yes,7,3,11,52
2,61,No,4,8,10,36
6,61,Yes,4,3,9,52
6,93,No,8,9,15,84
9,51,No,9,3,12,50
5,57,Yes,8,7,12,47
4,95,Yes,8,3,7,81
5,85,No,4,8,13,70
5,86,Yes,8,7,12,77
8,54,No,6,4,12,49
8,76,No,5,8,16,70
2,55,No,5,7,9,28
7,44,No,8,9,16,36
8,41,No,9,3,11,34
6,91,Yes,7,3,9,80
5,67,No,8,0,5,51
9,96,No,9,3,12,95
3,80,No,8,7,10,60
4,93,No,4,4,8,78
9,66,No,9,5,14,65
6,70,No,7,3,9,57
8,80,Yes,8,4,12,75
7,75,Yes,6,9,16,69
2,86,No,9,7,9,62
3,82,No,5,8,11,63
1,40,No,9,2,3,11
9,89,Yes,6,9,18,91
7,68,No,6,3,10,58
1,40,No,6,0,1,15
3,47,No,7,4,7,24
4,96,No,7,3,7,80
4,55,No,9,5,9,36
5,97,No,7,5,10,83
3,67,Yes,5,9,12,49
3,61,No,4,5,8,41
1,57,No,9,2,3,33
7,61,No,8,6,13,52
1,80,No,8,2,3,52
2,51,No,9,5,7,31
4,58,No,4,9,13,38
4,64,No,8,0,4,45
5,89,No,9,7,12,79
2,98,No,9,6,8,78
4,44,Yes,6,8,12,24
1,98,Yes,5,2,3,72
2,73,Yes,8,7,9,52
1,78,No,5,1,2,50
4,98,Yes,9,8,12,83
4,49,Yes,4,0,4,32
7,86,Yes,9,9,16,84
9,96,Yes,8,6,15,95
9,46,No,5,9,18,43
5,99,Yes,6,0,5,82
1,76,Yes,6,5,6,54
1,86,No,9,0,1,59
6,91,Yes,4,3,9,78
2,99,No,7,6,8,79
8,91,Yes,8,1,9,87
9,54,Yes,9,2,11,53
4,81,Yes,6,3,7,65
5,63,No,6,5,10,48
8,65,Yes,4,8,16,61
3,65,Yes,6,3,6,41
5,85,No,8,5,10,75
3,65,Yes,4,6,9,44
3,97,Yes,5,3,6,79
3,49,Yes,4,5,8,29
7,56,Yes,8,2,9,44
7,92,Yes,8,4,11,85
7,53,No,5,9,16,40
8,41,No,9,3,11,36
5,87,No,4,6,11,72
5,52,Yes,8,5,10,36
4,66,Yes,8,6,10,51
7,48,Yes,5,5,12,38
4,46,Yes,7,1,5,28
2,87,Yes,4,6,8,59
4,49,No,8,7,11,30
8,95,No,6,6,14,88
9,93,No,5,3,12,87
3,48,Yes,7,3,6,27
7,61,No,7,4,11,51
9,62,No,5,8,17,59
4,46,No,7,4,8,23
3,87,No,8,1,4,71
5,48,Yes,7,4,9,33
1,66,Yes,4,2,3,38
3,63,No,6,9,12,45
8,68,No,8,7,15,67
8,56,No,5,9,17,49
4,59,No,6,9,13,44
2,46,No,9,1,3,22
8,82,No,8,3,11,79
8,79,No,6,4,12,74
4,46,No,7,3,7,26
3,67,No,9,4,7,49
2,58,Yes,5,9,11,33
9,59,No,5,3,12,53
1,83,Yes,4,2,3,53
7,78,Yes,7,0,7,69
5,79,No,4,3,8,65
8,46,No,4,8,16,37
4,45,Yes,7,0,4,28
7,64,Yes,8,6,13,56
5,80,No,9,2,7,64
5,98,Yes,4,7,12,83
9,52,No,6,5,14,50
9,78,No,9,0,9,77
9,79,Yes,8,9,18,79
6,61,No,7,4,10,49
6,88,Yes,5,7,13,77
5,56,No,8,2,7,40
9,87,No,4,3,12,83
8,61,Yes,6,6,14,53
7,73,Yes,9,5,12,66
7,47,No,7,6,13,42
6,88,No,5,8,14,76
5,84,Yes,9,8,13,75
4,57,No,6,1,5,40
3,63,Yes,5,2,5,45
3,99,Yes,7,3,6,73
6,93,Yes,9,5,11,84
4,99,No,8,4,8,84
6,81,Yes,4,5,11,71
3,41,No,7,7,10,23
4,41,Yes,6,1,5,24
9,66,No,8,5,14,64
5,53,No,9,8,13,38
7,87,Yes,5,4,11,74
2,78,Yes,8,0,2,58
5,92,Yes,8,7,12,78
9,92,No,6,3,12,88
3,95,No,4,7,10,76
9,51,No,8,3,12,48
6,71,Yes,8,7,13,59
4,67,Yes,4,8,12,46
7,94,Yes,4,4,11,84
8,67,Yes,5,4,12,61
6,85,Yes,9,1,7,76
5,64,No,5,8,13,49
6,43,Yes,4,3,9,30
5,65,No,7,2,7,47
8,75,Yes,4,1,9,70
1,89,Yes,5,2,3,69
7,42,Yes,6,3,10,35
2,40,Yes,6,8,10,20
9,56,Yes,9,5,14,55
1,46,No,8,9,10,19
6,87,Yes,6,4,10,74
9,44,No,5,8,17,42
1,58,No,6,7,8,34
4,78,No,7,5,9,59
4,85,No,4,2,6,67
9,73,Yes,4,6,15,70
5,74,Yes,5,9,14,61
5,88,Yes,8,5,10,76
6,55,Yes,4,7,13,44
1,79,Yes,6,5,6,50
1,89,No,7,9,10,68
9,86,Yes,8,3,12,87
3,78,Yes,8,9,12,60
4,66,No,8,6,10,47
1,80,Yes,4,6,7,55
9,77,Yes,9,7,16,73
8,89,No,8,1,9,87
2,89,Yes,5,5,7,66
8,64,No,6,2,10,56
7,65,No,9,7,14,59
6,95,Yes,7,3,9,83
1,53,No,6,3,4,26
7,53,Yes,5,1,8,41
7,53,Yes,5,5,12,45
9,64,Yes,9,5,14,63
1,75,No,6,0,1,50
2,43,No,4,7,9,15
9,86,No,5,2,11,79
9,54,No,8,0,9,49
6,71,No,7,9,15,63
6,57,No,7,0,6,42
4,53,No,5,0,4,32
4,97,No,8,4,8,84
5,40,No,6,4,9,26
3,81,No,7,0,3,62
1,59,No,8,4,5,33
1,49,Yes,8,6,7,28
7,49,No,4,4,11,36
1,98,Yes,5,8,9,73
1,63,Yes,8,3,4,37
3,73,Yes,6,8,11,53
4,67,Yes,7,7,11,48
4,66,No,4,0,4,48
2,79,Yes,6,3,5,54
1,40,Yes,7,6,7,12
3,72,Yes,5,0,3,46
4,43,No,6,7,11,24
3,46,Yes,7,1,4,26
8,48,Yes,4,7,15,42
1,55,No,7,3,4,28
2,44,No,8,7,9,20
7,73,No,4,0,7,61
4,99,No,6,4,8,80
8,62,No,9,8,16,62
3,82,No,5,6,9,59
6,89,No,4,2,8,74
9,64,No,4,3,12,59
1,96,No,4,9,10,68
1,90,Yes,7,6,7,66
8,52,No,8,5,13,43
3,63,Yes,9,3,6,44
5,50,Yes,5,2,7,34
1,91,No,5,1,2,62
5,90,No,8,9,14,77
6,56,No,7,8,14,44
8,76,No,7,2,10,69
3,52,Yes,8,6,9,35
3,66,Yes,8,0,3,50
9,59,No,6,7,16,50
4,72,Yes,7,0,4,54
4,81,No,4,1,5,59
7,71,Yes,5,0,7,60
2,47,Yes,7,3,5,25
8,95,No,8,1,9,94
6,68,No,4,0,6,53
3,79,Yes,6,0,3,59
9,58,No,9,1,10,53
5,45,Yes,6,5,10,29
8,83,No,4,1,9,73
7,99,No,4,1,8,87
8,78,No,8,7,15,72
7,87,No,9,4,11,82
3,80,No,8,7,10,60
2,60,No,5,7,9,38
7,96,No,9,1,8,89
3,61,Yes,9,6,9,45
3,81,No,5,8,11,57
2,49,Yes,6,7,9,27
4,49,No,4,8,12,31
8,91,Yes,6,7,15,86
1,68,No,8,3,4,45
1,55,No,7,9,10,30
5,40,Yes,8,6,11,28
5,56,No,7,8,13,43
1,69,No,4,8,9,43
6,65,No,4,3,9,52
1,92,No,9,6,7,68
5,85,No,4,5,10,73
9,58,Yes,5,2,11,56
5,92,No,5,9,14,78
6,60,Yes,7,5,11,49
8,56,Yes,6,7,15,52
1,85,Yes,9,1,2,62
2,79,Yes,6,2,4,59
9,60,Yes,7,7,16,60
3,92,Yes,5,3,6,71
6,80,Yes,8,3,9,68
5,79,Yes,9,1,6,68
2,84,No,7,9,11,63
7,88,Yes,6,0,7,77
4,58,No,7,6,10,43
1,99,Yes,7,3,4,77
4,46,Yes,4,5,9,28
6,56,No,5,7,13,47
7,40,Yes,9,6,13,34
7,76,No,4,6,13,64
7,96,Yes,5,5,12,88
3,45,No,7,3,6,21
6,65,No,5,3,9,53
8,41,Yes,6,8,16,34
4,98,Yes,9,4,8,83
8,71,Yes,4,8,16,67
2,96,Yes,9,8,10,75
9,87,No,7,3,12,88
9,93,No,6,1,10,87
8,44,No,5,1,9,32
1,76,No,5,8,9,50
2,70,No,6,8,10,50
6,51,No,5,2,8,38
5,74,No,4,4,9,57
9,69,Yes,8,4,13,64
5,87,Yes,5,1,6,71
2,45,Yes,7,1,3,19
4,54,Yes,5,9,13,38
9,54,Yes,9,0,9,52
1,55,Yes,7,1,2,27
1,59,Yes,5,6,7,32
7,52,Yes,5,0,7,45
3,83,No,7,0,3,61
2,81,Yes,4,8,10,57
9,85,Yes,8,1,10,83
3,70,Yes,8,3,6,48
2,73,No,4,2,4,50
8,68,Yes,5,3,11,61
6,42,No,8,6,12,29
6,48,No,4,9,15,37
7,50,Yes,4,1,8,39
7,50,No,8,1,8,39
6,64,Yes,7,8,14,54
4,61,Yes,6,5,9,46
9,81,Yes,7,6,15,78
6,97,No,5,4,10,83
4,85,Yes,7,4,8,64
3,48,Yes,9,3,6,26
4,59,Yes,6,7,11,41
3,98,No,6,6,9,76
2,60,No,4,9,11,35
5,49,No,9,1,6,39
2,61,No,5,1,3,39
6,68,Yes,4,5,11,54
3,48,Yes,7,0,3,28
6,44,No,7,6,12,30
9,79,Yes,8,7,16,81
1,50,No,4,9,10,24
6,40,Yes,9,7,13,32
9,92,Yes,4,2,11,87
4,81,No,4,6,10,66
2,40,No,4,0,2,13
4,97,Yes,6,2,6,76
1,93,No,8,5,6,68
3,78,Yes,5,8,11,57
9,99,Yes,5,4,13,98
5,85,Yes,5,4,9,69
6,44,Yes,6,8,14,34
3,88,No,8,8,11,68
5,61,Yes,9,5,10,47
8,65,Yes,8,4,12,60
6,92,Yes,6,9,15,83
4,45,No,9,1,5,25
2,71,Yes,4,7,9,50
9,87,No,7,7,16,87
1,50,No,4,6,7,22
1,49,No,5,7,8,22
4,86,No,4,2,6,62
7,78,No,6,2,9,72
1,94,No,5,1,2,66
9,73,No,7,0,9,71
4,70,Yes,9,2,6,53
3,51,Yes,9,2,5,32
1,90,No,5,6,7,65
4,83,No,4,9,13,65
9,55,No,8,8,17,50
6,77,Yes,8,0,6,66
6,42,No,9,7,13,29
1,41,Yes,8,0,1,13
2,91,Yes,5,2,4,66
6,44,No,8,3,9,32
2,50,Yes,6,7,9,26
3,97,No,9,0,3,75
4,64,No,7,1,5,46
5,74,No,8,4,9,62
9,74,Yes,6,5,14,69
4,61,No,6,4,8,43
9,76,Yes,5,2,11,74
3,61,No,9,9,12,43
8,94,No,5,6,14,86
1,50,No,7,0,1,24
9,71,No,7,1,10,67
9,74,No,4,8,17,71
2,70,Yes,7,3,5,48
4,84,No,9,7,11,64
8,92,No,9,8,16,88
7,47,No,5,6,13,39
1,59,Yes,6,0,1,35
5,81,No,4,4,9,67
7,73,No,7,5,12,65
4,43,No,6,7,11,27
1,57,No,5,9,10,32
9,90,Yes,8,7,16,89
5,43,No,4,8,13,30
2,59,Yes,9,8,10,37
8,97,Yes,6,3,11,91
2,48,Yes,5,5,7,26
3,55,Yes,5,2,5,32
1,65,No,4,0,1,34
2,77,No,4,5,7,51
7,64,Yes,7,0,7,56
2,43,Yes,7,8,10,26
6,80,Yes,9,5,11,73
3,98,No,9,0,3,80
4,84,Yes,4,2,6,69
8,80,Yes,4,0,8,73
3,77,Yes,6,1,4,55
6,92,Yes,7,5,11,82
1,58,Yes,5,6,7,32
7,53,No,7,0,7,41
8,60,Yes,7,9,17,55
8,54,No,4,4,12,43
3,42,No,4,5,8,20
1,76,No,7,3,4,50
9,92,No,8,5,14,90
6,89,No,8,4,10,82
9,85,Yes,9,6,15,85
7,55,No,7,3,10,49
1,53,No,8,0,1,24
1,48,Yes,9,1,2,25
6,86,No,9,5,11,76
5,46,Yes,7,9,14,33
9,53,Yes,9,1,10,48
2,45,Yes,4,4,6,21
8,60,Yes,4,3,11,58
5,54,Yes,4,6,11,40
2,91,No,5,3,5,67
6,47,Yes,4,6,12,35
8,73,Yes,4,7,15,68
4,79,No,7,6,10,66
2,40,No,8,1,3,16
5,71,No,8,0,5,57
2,97,No,4,4,6,73
2,88,Yes,4,6,8,64
6,90,No,4,0,6,77
9,44,Yes,9,7,16,46
4,69,No,7,2,6,50
6,61,No,7,6,12,50
7,59,No,7,2,9,51
6,55,No,8,3,9,43
8,46,No,5,7,15,40
4,46,Yes,8,1,5,30
1,89,Yes,7,5,6,63
7,89,Yes,6,9,16,82
3,41,No,5,8,11,20
6,86,Yes,4,9,15,73
2,53,No,9,8,10,32
9,70,No,8,4,13,67
1,89,Yes,9,2,3,69
6,80,Yes,5,5,11,67
6,53,No,6,8,14,44
5,44,No,5,5,10,29
5,50,Yes,8,3,8,38
1,79,No,7,4,5,52
5,44,Yes,4,6,11,25
2,68,Yes,7,9,11,46
7,50,No,7,2,9,42
3,44,No,8,8,11,24
4,88,No,7,0,4,70
3,93,No,7,7,10,78
3,71,Yes,8,4,7,51
4,75,No,8,9,13,61
5,54,Yes,6,8,13,38
1,58,Yes,7,1,2,34
4,61,No,5,0,4,42
8,73,Yes,4,9,17,68
7,95,No,9,6,13,87
9,56,No,4,9,18,53
5,51,Yes,8,8,13,39
4,64,Yes,9,4,8,45
8,95,Yes,8,3,11,89
9,56,No,6,3,12,53
7,49,No,7,7,14,39
7,67,Yes,8,0,7,59
5,96,No,8,0,5,81
4,57,No,4,7,11,40
1,90,Yes,7,1,2,64
7,57,No,6,9,16,53
1,84,Yes,8,5,6,56
1,71,Yes,8,1,2,44
5,53,Yes,8,4,9,41
9,95,No,4,2,11,91
6,55,Yes,8,6,12,46
3,89,Yes,8,8,11,65
3,97,Yes,4,1,4,76
7,57,Yes,8,6,13,50
6,55,No,7,7,13,45
9,56,Yes,7,9,18,55
6,46,No,4,7,13,33
5,51,Yes,7,6,11,37
7,73,No,9,3,10,63
1,49,No,9,3,4,24
7,44,No,9,9,16,37
3,60,No,6,8,11,39
9,42,Yes,8,9,18,41
6,58,Yes,6,8,14,46
9,84,No,7,4,13,78
5,83,No,4,6,11,69
7,74,No,9,6,13,71
4,45,Yes,4,8,12,28
7,53,No,6,6,13,45
1,43,No,7,7,8,20
7,84,Yes,8,6,13,81
8,90,Yes,7,3,11,85
5,57,Yes,9,1,6,42
2,68,Yes,7,2,4,46
5,74,Yes,4,6,11,60
6,91,Yes,5,8,14,82
2,77,No,9,1,3,55
6,55,No,8,6,12,44
6,59,Yes,9,3,9,47
1,63,No,9,6,7,41
1,74,Yes,8,4,5,48
3,83,No,9,6,9,62
3,90,Yes,4,5,8,64
4,58,Yes,7,1,5,40
2,95,No,4,6,8,70
9,43,No,7,4,13,39
7,72,Yes,5,8,15,63
7,41,Yes,9,0,7,32
6,52,Yes,5,0,6,37
3,97,Yes,6,1,4,75
6,84,Yes,7,7,13,72
8,69,Yes,4,8,16,63
8,73,No,4,6,14,64
9,69,No,9,0,9,69
1,90,No,4,6,7,63
1,93,No,6,7,8,65
3,63,No,8,6,9,44
3,87,Yes,4,4,7,65
8,83,Yes,9,6,14,81
1,72,No,5,9,10,45
2,80,Yes,4,1,3,59
2,88,No,4,8,10,67
3,49,No,4,1,4,34
6,57,Yes,9,1,7,46
1,58,Yes,8,4,5,35
2,46,No,4,7,9,22
1,96,No,8,5,6,72
5,58,No,8,8,13,47
7,63,No,6,5,12,55
8,54,Yes,5,4,12,47
1,80,No,4,0,1,55
7,81,Yes,4,7,14,74
5,62,No,4,2,7,49
1,91,No,8,1,2,68
3,91,Yes,7,6,9,72
7,43,Yes,5,1,8,32
1,77,Yes,9,0,1,51
7,43,Yes,4,1,8,34
5,44,Yes,7,5,10,33
1,80,No,7,1,2,56
1,83,No,7,0,1,54
1,62,No,5,0,1,33
9,79,Yes,7,3,12,78
3,92,Yes,9,7,10,77
5,76,Yes,4,5,10,62
9,50,No,9,3,12,51
6,94,Yes,4,5,11,78
9,50,No,6,5,14,46
8,52,No,8,8,16,50
8,53,No,7,3,11,47
1,99,Yes,9,5,6,74
9,47,No,8,9,18,47
6,64,No,8,0,6,52
9,57,No,8,6,15,54
3,90,Yes,8,6,9,69
3,83,No,8,0,3,64
6,83,Yes,4,7,13,69
9,57,Yes,5,4,13,58
7,49,No,7,8,15,37
3,46,No,7,7,10,26
3,99,Yes,4,2,5,80
2,89,No,9,0,2,64
9,83,Yes,4,2,11,78
3,53,Yes,8,1,4,35
5,54,Yes,5,1,6,36
9,55,No,7,3,12,55
8,41,Yes,9,1,9,36
2,69,Yes,6,7,9,46
3,69,No,4,4,7,51
2,57,No,6,0,2,30
8,70,Yes,7,5,13,68
6,83,Yes,4,6,12,69
6,87,Yes,7,0,6,78
9,52,No,4,2,11,51
8,59,Yes,9,8,16,55
4,88,Yes,7,6,10,72
4,89,No,6,3,7,71
9,74,No,5,5,14,69
1,62,Yes,9,5,6,38
2,81,No,9,2,4,61
2,72,Yes,4,1,3,49
6,77,Yes,6,4,10,67
4,74,No,7,7,11,56
3,90,Yes,6,2,5,68
3,75,Yes,9,4,7,60
3,59,No,4,2,5,34
6,94,Yes,6,6,12,83
8,42,No,7,5,13,37
7,47,Yes,8,5,12,42
4,79,No,9,0,4,62
4,98,No,5,1,5,80
2,71,No,5,5,7,46
1,68,No,9,7,8,47
9,46,No,8,4,13,46
2,41,No,4,1,3,13
8,60,Yes,6,4,12,55
9,45,Yes,6,8,17,42
4,67,No,8,5,9,51
8,87,Yes,8,4,12,81
9,81,No,7,9,18,75
5,75,No,7,5,10,59
7,71,Yes,5,8,15,62
4,84,No,4,6,10,65
1,81,Yes,4,9,10,51
3,92,No,8,2,5,73
5,85,No,5,9,14,68
3,48,Yes,5,9,12,28
7,50,No,7,4,11,39
9,62,No,6,3,12,55
6,89,No,4,4,10,76
1,50,Yes,5,7,8,24
7,88,Yes,7,5,12,81
3,41,Yes,7,3,6,24
5,42,Yes,7,4,9,29
4,50,Yes,6,6,10,37
5,89,No,5,7,12,74
5,98,Yes,8,4,9,84
6,74,Yes,8,1,7,64
6,97,No,7,5,11,90
8,54,No,7,8,16,46
8,82,Yes,6,2,10,79
9,50,No,7,6,15,48
8,70,No,9,7,15,65
2,67,No,5,5,7,46
1,67,Yes,7,2,3,39
2,71,No,7,0,2,49
2,64,No,5,2,4,39
3,59,Yes,4,5,8,40
7,67,No,9,3,10,60
2,64,No,9,0,2,43
1,50,Yes,8,5,6,25
6,58,Yes,7,0,6,45
9,67,Yes,5,7,16,64
3,40,No,8,2,5,20
6,98,Yes,6,2,8,87
3,44,Yes,4,0,3,23
1,49,No,7,2,3,23
5,81,No,4,6,11,67
4,85,No,7,9,13,74
7,73,No,7,7,14,64
6,75,No,7,7,13,66
7,41,Yes,4,2,9,29
5,57,Yes,9,4,9,42
4,52,Yes,6,0,4,37
7,90,No,9,8,15,82
7,44,Yes,5,7,14,35
6,59,No,5,9,15,46
8,41,No,9,1,9,40
4,50,Yes,6,9,13,34
5,69,Yes,6,0,5,52
4,71,No,7,3,7,52
1,71,No,7,8,9,50
8,97,Yes,5,7,15,91
1,89,Yes,7,2,3,64
5,77,No,7,9,14,67
6,94,No,6,5,11,85
6,67,No,4,8,14,53
5,49,No,9,9,14,35
3,61,Yes,8,7,10,41
5,94,Yes,8,9,14,81
8,56,No,7,4,12,52
2,61,No,7,8,10,39
6,82,Yes,9,8,14,72
9,58,No,8,2,11,55
8,56,No,6,7,15,49
8,63,No,8,3,11,60
8,75,No,8,9,17,69
7,71,No,8,6,13,63
8,97,No,7,9,17,94
6,95,Yes,7,7,13,86
2,97,No,9,6,8,75
2,85,Yes,8,4,6,66
8,98,Yes,7,0,8,97
1,91,Yes,9,7,8,71
6,75,No,8,4,10,59
6,67,No,6,2,8,54
4,53,No,7,1,5,34
3,97,Yes,4,2,5,77
3,75,Yes,9,8,11,60
1,45,No,7,1,2,16
3,48,No,6,9,12,30
4,60,Yes,6,0,4,42
5,51,Yes,7,1,6,36
3,97,Yes,5,1,4,77
6,69,No,9,4,10,58
5,70,Yes,8,0,5,58
3,79,Yes,8,9,12,60
6,95,Yes,6,7,13,87
6,43,No,7,1,7,30
8,70,No,5,5,13,59
2,66,No,9,4,6,42
1,97,Yes,4,1,2,70
4,96,Yes,8,9,13,82
7,64,Yes,9,0,7,56
3,44,Yes,9,5,8,24
3,45,No,5,5,8,27
5,44,Yes,9,2,7,33
5,90,Yes,8,7,12,75
3,66,No,7,8,11,45
9,47,Yes,8,2,11,45
4,48,Yes,4,8,12,30
3,54,Yes,7,7,10,29
2,75,No,6,4,6,50
9,96,Yes,5,5,14,95
4,80,No,8,0,4,63
3,46,Yes,7,4,7,24
7,71,No,9,9,16,63
8,47,No,7,9,17,41
2,86,No,8,6,8,69
7,90,Yes,6,0,7,81
5,54,Yes,8,9,14,40
5,76,No,6,8,13,66
3,58,No,9,6,9,40
5,78,Yes,8,3,8,63
2,45,No,7,3,5,21
4,98,Yes,4,9,13,81
6,58,Yes,4,6,12,47
1,96,No,9,5,6,69
4,67,No,7,2,6,47
6,56,Yes,4,8,14,44
9,81,Yes,9,5,14,78
2,58,Yes,6,1,3,36
7,70,No,7,9,16,60
6,50,Yes,6,1,7,43
2,54,No,7,0,2,30
8,49,No,6,4,12,43
7,82,Yes,6,9,16,75
5,62,No,4,5,10,46
5,42,No,7,2,7,29
7,42,No,8,3,10,33
9,57,No,4,4,13,51
9,64,Yes,6,3,12,58
9,82,Yes,6,8,17,81
6,59,No,8,2,8,49
6,97,No,8,4,10,84
3,68,No,6,6,9,47
1,61,No,8,6,7,38
7,89,No,5,5,12,78
4,96,Yes,4,8,12,77
1,54,Yes,7,6,7,29
8,78,Yes,8,3,11,76
6,49,Yes,8,9,15,41
6,60,No,5,8,14,51
2,94,No,7,5,7,70
1,91,Yes,5,0,1,63
2,68,Yes,7,8,10,46
4,71,Yes,4,6,10,53
2,49,No,8,5,7,25
1,52,No,4,5,6,26
7,86,No,7,3,10,74
8,62,Yes,8,3,11,57
6,89,Yes,5,2,8,80
4,62,No,6,7,11,45
6,70,No,5,7,13,56
3,43,No,6,1,4,19
8,91,Yes,5,4,12,86
2,88,No,7,8,10,70
5,99,No,4,8,13,85
1,42,Yes,6,6,7,16
6,60,No,7,3,9,47
2,92,No,4,3,5,65
4,41,No,4,9,13,23
6,43,No,8,6,12,29
8,40,Yes,8,2,10,36
8,54,No,8,2,10,49
6,96,Yes,6,4,10,85
4,72,No,6,5,9,56
8,45,Yes,4,7,15,39
8,46,No,6,0,8,40
1,58,No,4,6,7,33
4,83,Yes,7,7,11,67
4,40,No,5,4,8,19
7,78,No,4,9,16,74
7,58,Yes,4,1,8,47
8,84,No,7,3,11,77
5,65,No,8,5,10,52
7,83,No,9,8,15,76
8,51,No,8,1,9,42
9,61,No,8,3,12,56
3,52,Yes,4,9,12,30
3,67,Yes,4,4,7,47
4,53,No,6,7,11,34
5,61,No,6,7,12,48
1,69,Yes,5,1,2,42
7,83,Yes,5,5,12,74
9,59,Yes,9,5,14,58
8,83,Yes,6,4,12,75
5,66,Yes,4,7,12,54
4,77,Yes,7,9,13,62
7,98,No,6,1,8,88
5,81,No,4,1,6,64
7,91,No,6,6,13,81
1,95,No,8,8,9,69
1,80,No,6,2,3,51
3,73,Yes,9,6,9,52
2,78,Yes,8,2,4,58
2,80,Yes,4,5,7,55
7,96,Yes,8,2,9,86
2,83,Yes,6,0,2,62
4,76,Yes,8,5,9,60
2,40,No,9,2,4,15
6,93,No,7,0,6,82
8,54,Yes,8,4,12,52
4,71,No,9,7,11,57
5,47,Yes,8,7,12,34
4,72,No,5,7,11,55
3,57,Yes,7,2,5,39
5,84,Yes,4,7,12,73
9,68,No,9,3,12,64
8,71,Yes,8,7,15,67
8,72,No,7,2,10,67
8,44,No,4,2,10,36
8,57,Yes,7,0,8,52
7,87,Yes,9,7,14,85
8,97,Yes,5,7,15,91
8,49,No,9,8,16,42
8,75,No,9,5,13,74
7,72,Yes,4,1,8,65
1,62,Yes,4,0,1,36
4,79,Yes,8,7,11,63
4,44,Yes,6,9,13,29
5,73,Yes,9,3,8,60
6,63,Yes,4,6,12,50
4,56,Yes,9,9,13,40
2,70,No,9,3,5,48
6,46,No,4,0,6,33
8,56,Yes,5,7,15,51
8,67,Yes,5,9,17,64
7,77,No,9,8,15,70
6,61,Yes,5,9,15,49
2,54,No,9,8,10,33
7,76,No,8,8,15,69
5,54,Yes,4,3,8,41
6,89,No,9,8,14,79
8,89,No,5,3,11,81
8,64,Yes,5,1,9,57
3,92,Yes,7,9,12,73
7,60,No,7,2,9,49
1,94,Yes,5,1,2,64
1,77,No,8,0,1,49
7,41,No,6,5,12,31
9,66,No,9,3,12,61
7,88,No,7,6,13,81
5,71,No,9,6,11,59
8,60,No,7,9,17,54
2,43,Yes,4,0,2,18
9,83,Yes,4,8,17,80
6,58,Yes,5,7,13,43
9,41,Yes,4,9,18,39
2,65,No,4,0,2,39
3,73,No,6,7,10,51
8,53,No,8,4,12,49
1,54,No,5,0,1,27
7,59,No,6,3,10,51
7,73,Yes,5,6,13,64
1,75,Yes,8,4,5,51
9,58,Yes,5,2,11,56
8,48,No,9,3,11,46
4,46,No,9,1,5,28
5,69,Yes,9,7,12,57
2,52,No,4,1,3,28
9,66,No,8,5,14,65
6,83,Yes,6,6,12,71
3,74,No,6,6,9,54
7,52,Yes,7,0,7,44
9,54,Yes,6,7,16,52
3,85,Yes,9,8,11,71
2,95,Yes,9,6,8,74
7,48,No,7,7,14,38
7,84,No,4,3,10,75
4,62,No,6,7,11,43
9,93,Yes,8,2,11,90
8,75,No,7,0,8,69
1,92,Yes,6,7,8,67
1,79,No,4,5,6,52
5,42,No,8,8,13,27
6,73,Yes,8,2,8,63
3,58,No,4,7,10,41
9,67,Yes,6,8,17,67
6,62,Yes,5,8,14,47
4,79,No,6,6,10,61
7,88,No,7,9,16,82
8,84,No,7,2,10,75
9,46,No,6,2,11,37
6,80,Yes,9,1,7,68
6,51,Yes,7,0,6,37
8,53,No,5,1,9,49
5,85,No,9,4,9,73
3,54,No,5,0,3,32
3,42,Yes,8,9,12,23
6,54,No,7,3,9,43
2,90,Yes,9,9,11,70
6,63,No,6,9,15,53
6,91,No,9,0,6,81
8,85,Yes,8,9,17,84
7,47,Yes,5,7,14,38
8,44,No,8,4,12,40
9,90,Yes,4,9,18,88
6,43,Yes,7,3,9,32
3,53,No,6,2,5,31
3,55,Yes,5,8,11,35
1,59,Yes,8,5,6,34
5,63,No,6,0,5,49
4,45,No,7,7,11,28
9,94,Yes,6,9,18,91
9,96,No,7,1,10,90
5,70,Yes,7,8,13,55
4,45,Yes,7,6,10,27
7,74,Yes,8,2,9,67
6,54,No,7,3,9,41
4,68,Yes,6,2,6,53
2,42,Yes,4,5,7,15
1,50,Yes,6,8,9,26
4,42,No,8,9,13,22
4,67,No,7,8,12,48
1,49,No,4,0,1,19
6,89,Yes,8,9,15,78
4,72,Yes,5,5,9,53
1,87,No,5,0,1,61
1,55,Yes,5,3,4,30
1,98,Yes,4,6,7,70
8,49,Yes,6,3,11,42
8,72,Yes,4,8,16,67
2,75,No,4,9,11,51
7,42,No,4,4,11,35
8,44,No,5,8,16,38
8,51,Yes,9,0,8,44
7,96,Yes,6,3,10,86
5,83,No,9,6,11,68
1,52,No,9,1,2,25
9,63,No,4,8,17,59
7,83,Yes,6,2,9,74
2,96,No,9,3,5,73
6,71,Yes,7,3,9,61
2,55,No,4,7,9,32
1,71,Yes,4,1,2,41
7,84,Yes,4,4,11,72
2,76,No,7,1,3,51
2,95,Yes,7,5,7,72
5,75,Yes,5,8,13,60
5,60,No,8,8,13,46
7,86,No,6,0,7,77
1,51,No,8,3,4,23
8,90,Yes,4,3,11,82
3,60,Yes,9,0,3,37
4,99,No,4,9,13,80
9,90,No,9,1,10,87
4,60,Yes,5,5,9,41
5,82,No,8,9,14,67
7,92,No,4,2,9,81
4,45,Yes,8,8,12,30
1,48,Yes,5,2,3,19
9,40,No,8,2,11,39
4,51,Yes,9,8,12,34
9,97,Yes,6,2,11,93
6,53,No,5,5,11,43
1,45,No,8,5,6,21
3,40,No,4,0,3,17
2,61,Yes,7,6,8,40
9,73,No,7,8,17,68
1,95,Yes,5,8,9,74
9,50,No,7,8,17,45
9,42,Yes,6,1,10,38
8,81,Yes,5,0,8,76
8,45,No,4,5,13,38
1,45,Yes,4,5,6,18
8,59,No,5,3,11,54
3,60,No,7,7,10,42
7,41,Yes,7,4,11,31
1,65,Yes,4,6,7,42
1,70,Yes,6,8,9,44
5,65,No,9,0,5,54
5,95,No,7,8,13,83
8,71,No,6,3,11,64
7,49,No,7,6,13,38
8,62,No,9,3,11,57
6,97,No,5,3,9,83
6,45,Yes,8,3,9,34
2,62,No,4,5,7,39
6,67,No,5,4,10,56
5,88,No,7,1,6,76
3,69,No,9,8,11,49
6,53,Yes,4,5,11,41
8,76,Yes,8,9,17,69
9,94,Yes,8,5,14,93
1,71,No,9,8,9,44
3,88,No,9,0,3,73
3,73,No,7,6,9,56
8,80,Yes,4,2,10,70
1,83,No,7,3,4,56
5,90,No,8,0,5,77
3,61,Yes,5,2,5,40
2,70,Yes,5,6,8,47
8,46,No,6,5,13,40
3,80,Yes,8,0,3,62
7,60,No,8,8,15,57
1,55,No,7,3,4,26
6,59,Yes,6,6,12,47
3,82,No,9,3,6,59
8,83,Yes,6,6,14,78
6,86,Yes,4,4,10,77
2,89,No,7,0,2,67
6,58,Yes,9,3,9,49
7,87,No,9,2,9,80
5,71,No,5,5,10,54
3,54,Yes,4,5,8,30
4,44,Yes,6,0,4,29
4,50,Yes,5,1,5,31
6,54,No,8,1,7,42
1,68,No,7,9,10,39
4,89,No,6,3,7,70
4,84,No,8,8,12,69
1,43,No,9,1,2,18
9,88,No,6,7,16,89
4,75,No,5,0,4,56
7,87,Yes,4,7,14,78
3,62,No,5,2,5,44
3,54,No,7,4,7,36
8,85,Yes,7,0,8,76
8,83,No,6,0,8,79
1,42,No,5,5,6,12
2,71,Yes,4,2,4,48
8,49,No,9,7,15,46
1,79,Yes,7,3,4,54
8,77,No,4,5,13,69
8,61,No,8,9,17,56
2,53,Yes,6,8,10,26
4,56,Yes,4,7,11,39
6,60,No,6,3,9,48
9,90,No,8,9,18,92
8,87,Yes,4,7,15,81
8,54,No,4,6,14,46
7,97,Yes,9,4,11,89
9,54,Yes,8,6,15,51
2,40,Yes,5,6,8,16
3,63,No,4,9,12,40
8,94,No,9,1,9,90
6,94,No,4,6,12,83
9,51,Yes,9,2,11,46
4,49,No,7,7,11,32
8,85,Yes,5,7,15,82
3,81,Yes,4,8,11,63
3,81,No,8,3,6,59
8,91,No,6,9,17,89
5,70,Yes,8,2,7,55
3,50,No,5,8,11,29
1,93,Yes,7,8,9,68
3,55,No,7,1,4,32
9,48,Yes,7,5,14,44
5,86,No,9,2,7,75
2,53,Yes,8,4,6,33
7,58,No,6,1,8,49
2,70,Yes,6,3,5,47
4,48,Yes,9,2,6,35
7,75,Yes,4,1,8,67
4,92,Yes,9,5,9,77
7,78,Yes,6,2,9,65
7,93,Yes,6,3,10,86
1,65,No,4,5,6,40
6,47,Yes,8,4,10,37
9,63,Yes,8,3,12,57
2,47,No,5,3,5,23
3,58,No,8,1,4,42
5,86,Yes,7,9,14,73
9,87,No,7,3,12,88
4,69,No,5,7,11,53
1,97,Yes,6,4,5,72
4,61,Yes,5,9,13,47
6,94,No,4,9,15,81
5,48,No,5,7,12,30
1,97,No,5,5,6,68
4,97,No,9,9,13,83
6,83,No,7,4,10,73
4,87,No,4,3,7,67
9,43,Yes,9,9,18,45
5,76,No,4,8,13,61
8,47,Yes,5,9,17,43
9,40,Yes,9,4,13,37
5,67,No,9,9,14,54
6,45,Yes,4,5,11,29
1,86,No,4,6,7,59
7,75,Yes,8,0,7,67
4,92,No,4,8,12,73
2,50,Yes,9,7,9,29
5,44,No,6,4,9,29
3,89,Yes,4,2,5,67
6,63,No,7,4,10,51
8,86,Yes,8,4,12,80
7,57,Yes,7,8,15,48
3,59,Yes,7,6,9,42
8,67,No,6,1,9,57
2,52,No,8,4,6,31
9,44,No,5,8,17,38
4,69,No,9,1,5,55
1,40,No,9,7,8,16
8,61,Yes,4,2,10,53
7,57,No,9,3,10,51
5,85,No,6,1,6,72
5,44,Yes,9,8,13,33
7,70,No,6,5,12,62
5,45,No,5,8,13,30
8,66,No,6,7,15,63
6,95,No,5,8,14,84
5,64,No,5,4,9,49
9,68,No,5,5,14,66
2,67,Yes,6,6,8,44
1,55,No,5,4,5,30
8,93,No,6,0,8,88
3,92,No,8,8,11,79
7,51,Yes,5,1,8,41
8,59,Yes,6,6,14,55
6,57,Yes,6,7,13,47
9,73,Yes,6,7,16,72
7,94,No,4,0,7,83
5,92,Yes,4,9,14,79
8,62,No,5,6,14,56
2,84,No,9,8,10,65
7,66,No,8,2,9,53
4,88,Yes,9,7,11,73
9,56,No,5,7,16,57
1,87,Yes,7,8,9,66
7,60,No,7,7,14,52
6,89,Yes,8,4,10,80
8,79,Yes,8,4,12,75
5,70,No,8,2,7,57
1,42,No,4,5,6,13
1,56,No,4,9,10,28
9,89,Yes,7,2,11,85
6,97,Yes,8,1,7,86
5,65,Yes,6,6,11,54
1,62,No,9,9,10,36
6,45,Yes,7,2,8,37
6,67,No,8,3,9,57
3,47,Yes,6,9,12,25
8,94,Yes,8,7,15,89
1,97,Yes,5,0,1,71
1,84,No,6,8,9,56
6,47,No,9,5,11,36
1,58,No,5,1,2,28
6,77,Yes,4,2,8,66
1,68,Yes,7,4,5,41
6,62,Yes,8,5,11,49
3,86,Yes,7,8,11,71
8,71,No,9,1,9,65
6,49,Yes,8,4,10,37
1,66,Yes,5,6,7,41
5,88,No,6,6,11,74
8,40,No,6,3,11,31
3,78,No,8,2,5,57
6,68,Yes,5,7,13,58
5,98,No,8,1,6,82
6,84,Yes,8,4,10,74
1,42,No,8,9,10,21
7,90,Yes,6,4,11,81
9,86,Yes,9,0,9,87
2,76,Yes,8,6,8,53
5,70,Yes,6,3,8,56
4,50,Yes,4,9,13,35
6,61,Yes,5,1,7,47
6,57,No,4,7,13,48
2,74,Yes,8,3,5,52
2,45,Yes,6,0,2,19
4,42,Yes,5,7,11,27
1,44,Yes,7,6,7,22
9,48,No,5,2,11,41
7,67,Yes,5,2,9,58
7,58,Yes,8,6,13,49
3,67,No,4,1,4,43
3,66,Yes,4,4,7,43
1,52,No,7,6,7,27
3,77,Yes,8,5,8,61
3,82,Yes,5,9,12,63
4,92,No,9,6,10,77
4,60,No,4,1,5,39
3,66,No,4,6,9,45
8,85,Yes,6,1,9,77
8,45,No,5,6,14,34
1,77,No,8,7,8,51
7,88,Yes,4,9,16,82
2,50,Yes,8,7,9,23
1,86,Yes,5,4,5,62
3,80,No,5,6,9,60
4,92,Yes,4,7,11,75
6,56,No,7,3,9,43
5,95,No,8,1,6,82
4,78,No,8,6,10,65
8,46,No,6,0,8,39
4,69,Yes,5,1,5,50
2,60,Yes,5,9,11,43
3,40,No,4,6,9,19
6,64,No,4,9,15,49
8,71,Yes,4,0,8,64
8,98,Yes,6,6,14,92
9,96,No,7,4,13,93
7,47,No,4,2,9,39
2,44,No,4,1,3,20
8,69,No,9,6,14,61
7,90,No,4,8,15,77
8,47,Yes,6,8,16,42
3,88,No,8,9,12,72
7,58,Yes,7,9,16,46
9,83,No,8,7,16,83
3,98,Yes,9,1,4,84
6,94,No,5,0,6,83
2,69,Yes,5,7,9,45
2,54,Yes,4,1,3,31
5,75,No,9,3,8,62
5,94,No,8,3,8,84
7,83,Yes,6,1,8,76
2,66,Yes,7,3,5,42
7,52,Yes,8,6,13,46
5,53,No,9,5,10,38
6,76,Yes,9,9,15,69
8,93,No,8,5,13,88
4,87,No,7,3,7,70
7,69,No,8,1,8,61
6,78,No,8,4,10,66
2,86,No,7,2,4,63
8,52,No,6,2,10,46
9,97,Yes,9,3,12,95
5,55,Yes,7,4,9,41
4,83,No,4,1,5,62
6,46,Yes,4,5,11,31
8,87,Yes,4,5,13,81
3,94,No,4,7,10,76
1,94,Yes,5,1,2,70
4,66,No,6,7,11,51
4,84,No,5,7,11,69
1,94,No,8,3,4,69
9,74,No,8,6,15,71
3,54,Yes,7,6,9,34
5,67,Yes,4,0,5,51
6,74,No,7,0,6,60
8,46,Yes,8,7,15,43
6,89,No,4,0,6,74
3,85,No,9,2,5,62
6,89,Yes,6,5,11,80
1,90,Yes,8,7,8,67
4,85,No,9,4,8,65
6,59,Yes,7,4,10,47
7,71,No,9,3,10,63
3,77,No,7,3,6,57
9,79,Yes,8,6,15,82
7,71,No,5,5,12,60
1,65,Yes,6,7,8,38
2,97,No,9,5,7,78
1,78,No,9,9,10,54
9,59,No,8,6,15,59
9,57,No,8,9,18,55
7,89,No,7,9,16,84
3,54,Yes,4,4,7,32
5,91,No,4,5,10,75
4,61,Yes,4,0,4,40
7,90,Yes,7,2,9,85
9,61,Yes,4,7,16,56
2,92,No,8,2,4,67
8,60,Yes,5,0,8,56
9,41,Yes,5,2,11,38
9,79,Yes,5,3,12,79
7,92,No,4,7,14,81
9,82,No,5,8,17,80
9,57,No,9,3,12,57
3,62,No,4,6,9,38
4,52,Yes,9,0,4,36
2,80,No,8,8,10,58
3,48,Yes,9,3,6,28
5,88,No,8,8,13,74
5,46,Yes,7,2,7,32
6,80,No,7,4,10,68
7,93,No,9,0,7,83
7,40,No,6,2,9,33
1,41,No,8,4,5,15
2,43,Yes,4,5,7,16
9,53,No,6,7,16,48
2,71,No,8,0,2,45
6,75,No,4,2,8,60
1,41,Yes,8,0,1,16
3,79,No,8,4,7,61
2,89,No,4,7,9,67
3,90,Yes,8,3,6,70
5,53,Yes,8,8,13,40
6,59,Yes,8,5,11,49
9,64,No,7,5,14,63
4,81,Yes,5,4,8,63
7,88,No,8,9,16,82
6,47,Yes,4,4,10,33
2,67,No,9,6,8,41
8,85,Yes,8,7,15,83
7,60,Yes,7,6,13,53
7,62,Yes,7,0,7,53
8,71,No,9,0,8,66
1,47,Yes,8,9,10,25
1,70,No,6,5,6,44
8,76,Yes,9,2,10,66
4,55,Yes,5,8,12,34
5,79,Yes,4,6,11,67
8,81,No,4,1,9,74
5,66,No,4,2,7,52
4,79,No,4,7,11,64
6,80,Yes,7,0,6,71
5,57,No,5,4,9,39
7,74,No,8,9,16,66
7,88,Yes,8,0,7,78
4,91,Yes,6,8,12,75
5,54,No,8,6,11,37
3,92,No,5,4,7,71
4,66,Yes,8,5,9,47
4,56,No,7,2,6,37
3,79,Yes,9,2,5,63
5,41,Yes,8,6,11,26
5,88,No,4,6,11,71
7,89,No,4,6,13,80
4,70,Yes,9,1,5,54
4,76,No,4,1,5,57
9,80,Yes,4,4,13,75
6,80,No,7,3,9,67
4,73,Yes,7,6,10,57
2,73,No,7,2,4,52
6,90,No,8,4,10,78
2,94,Yes,9,1,3,72
5,98,No,4,0,5,78
6,42,Yes,6,8,14,30
4,56,No,9,3,7,40
3,53,No,6,7,10,35
7,53,No,4,6,13,41
2,85,No,5,0,2,61
6,77,Yes,9,9,15,69
4,74,Yes,8,6,10,55
6,40,No,6,1,7,24
4,87,Yes,9,2,6,72
4,68,Yes,9,0,4,52
4,43,No,7,6,10,26
9,72,Yes,5,2,11,66
7,56,Yes,7,5,12,45
3,67,No,5,6,9,47
3,89,No,5,2,5,68
6,65,No,8,1,7,49
6,47,No,9,8,14,37
4,73,Yes,7,8,12,61
9,98,No,7,6,15,97
4,57,Yes,6,4,8,38
9,70,Yes,9,3,12,69
4,98,No,4,3,7,79
2,66,Yes,4,0,2,45
2,55,Yes,6,3,5,29
5,97,Yes,5,6,11,86
4,49,No,6,4,8,29
7,79,Yes,6,8,15,72
5,51,No,7,3,8,37
6,61,No,6,2,8,51
4,55,Yes,5,5,9,39
2,51,Yes,4,3,5,24
9,50,No,8,1,10,47
7,59,No,9,4,11,52
4,90,No,6,3,7,75
3,40,No,9,4,7,18
3,66,No,6,8,11,44
9,42,Yes,9,3,12,37
5,51,No,7,5,10,37
3,69,Yes,7,3,6,50
5,48,No,9,0,5,34
2,92,Yes,6,1,3,68
4,93,No,6,5,9,76
2,76,Yes,5,7,9,53
2,40,Yes,4,8,10,16
8,81,No,4,3,11,70
1,88,Yes,8,5,6,62
7,43,No,4,2,9,33
5,54,No,8,8,13,40
8,90,Yes,7,7,15,85
1,66,Yes,8,0,1,43
7,47,No,8,1,8,40
5,99,No,4,9,14,83
4,99,No,6,8,12,86
7,62,Yes,7,9,16,54
2,54,Yes,5,2,4,32
1,66,No,8,2,3,40
1,70,Yes,8,9,10,45
1,78,Yes,9,8,9,56
5,86,Yes,8,2,7,71
7,47,No,6,9,16,38
2,69,No,5,4,6,45
8,97,Yes,9,5,13,93
4,94,Yes,4,2,6,73
3,81,No,7,9,12,63
8,57,Yes,6,7,15,54
2,43,No,5,1,3,18
3,86,No,7,5,8,65
3,82,No,4,1,4,64
1,61,No,7,8,9,35
6,42,No,9,5,11,31
2,54,No,8,8,10,26
1,74,No,8,3,4,46
2,86,Yes,6,2,4,65
6,77,No,7,1,7,72
4,72,Yes,8,7,11,59
6,53,Yes,6,3,9,39
9,87,Yes,6,1,10,85
8,40,No,9,8,16,35
1,92,Yes,6,7,8,67
8,88,No,4,4,12,78
9,65,No,8,7,16,64
6,47,Yes,8,4,10,34
5,89,Yes,5,6,11,70
6,55,Yes,4,4,10,42
6,77,Yes,8,4,10,61
9,49,No,9,3,12,45
4,81,Yes,8,4,8,66
2,76,Yes,5,6,8,56
9,65,Yes,7,2,11,63
2,67,Yes,7,3,5,44
9,51,Yes,4,7,16,46
2,59,No,6,5,7,34
8,88,No,5,7,15,85
9,53,No,5,1,10,46
9,85,Yes,8,8,17,84
9,74,Yes,9,6,15,74
2,68,No,8,4,6,41
4,51,No,9,6,10,30
7,91,No,5,1,8,82
2,57,No,6,3,5,30
1,83,Yes,7,6,7,59
3,41,Yes,4,1,4,17
4,41,Yes,9,7,11,26
8,98,No,7,9,17,94
6,56,No,4,9,15,46
2,49,No,6,4,6,26
9,57,Yes,5,4,13,54
2,61,Yes,6,7,9,42
5,58,No,9,0,5,42
4,97,Yes,5,5,9,80
7,92,No,8,1,8,85
8,40,No,4,0,8,26
5,63,No,8,6,11,52
5,75,Yes,5,3,8,60
2,64,No,4,0,2,40
8,75,No,4,9,17,68
2,70,Yes,8,5,7,49
6,70,No,4,9,15,59
8,41,No,5,5,13,32
6,58,Yes,9,2,8,47
4,92,No,9,5,9,77
4,51,No,5,9,13,36
6,49,No,8,8,14,38
4,70,Yes,6,5,9,50
8,84,No,5,0,8,77
9,61,No,9,9,18,59
1,62,No,5,5,6,37
4,91,Yes,4,7,11,72
4,62,Yes,4,6,10,41
2,54,Yes,5,7,9,34
6,65,No,8,7,13,54
3,42,Yes,6,8,11,21
7,62,No,4,2,9,50
5,59,Yes,9,6,11,49
4,84,Yes,4,5,9,71
5,79,Yes,9,1,6,64
8,96,Yes,6,4,12,90
3,78,No,4,2,5,57
7,95,Yes,8,4,11,84
6,47,No,9,8,14,36
1,57,No,4,7,8,34
7,80,No,4,8,15,70
7,45,Yes,5,8,15,39
1,66,Yes,8,7,8,42
9,75,No,8,7,16,69
6,54,Yes,5,5,11,44
2,76,No,9,5,7,54
5,97,Yes,7,5,10,87
4,44,Yes,6,9,13,28
7,78,No,8,5,12,70
8,48,Yes,7,8,16,44
1,46,No,9,9,10,23
5,80,No,6,0,5,61
3,59,Yes,8,9,12,43
1,49,Yes,4,5,6,22
3,65,Yes,8,7,10,47
6,43,No,6,0,6,31
7,77,Yes,7,5,12,71
8,63,Yes,4,8,16,59
4,53,Yes,6,5,9,37
3,80,Yes,9,1,4,58
5,40,No,6,0,5,24
9,56,Yes,8,3,12,52
6,84,No,9,5,11,74
9,63,Yes,5,9,18,60
6,66,Yes,5,9,15,59
2,46,Yes,4,8,10,20
5,48,No,6,4,9,33
9,82,No,7,6,15,80
8,74,Yes,4,5,13,67
7,97,No,9,5,12,90
1,51,No,4,8,9,29
4,60,Yes,8,4,8,44
7,42,Yes,9,1,8,37
7,54,Yes,7,7,14,45
6,60,Yes,6,2,8,50
8,49,Yes,9,8,16,44
6,72,Yes,6,4,10,59
3,85,No,6,0,3,60
4,98,Yes,4,3,7,78
3,91,Yes,8,8,11,73
1,45,Yes,4,0,1,20
5,41,Yes,5,7,12,26
1,68,No,5,7,8,42
1,94,No,6,8,9,71
2,79,No,8,8,10,57
4,72,Yes,9,5,9,55
6,43,Yes,6,4,10,29
8,98,No,9,6,14,96
3,43,No,6,8,11,23
1,68,Yes,4,4,5,42
3,76,Yes,6,2,5,54
3,99,Yes,6,8,11,83
5,99,Yes,8,9,14,91
4,59,Yes,8,0,4,42
4,80,No,9,0,4,65
9,62,Yes,8,9,18,60
7,84,No,6,3,10,77
4,57,Yes,8,1,5,41
3,88,No,8,6,9,67
6,64,No,7,1,7,53
3,40,No,7,6,9,21
6,93,Yes,5,7,13,82
9,54,Yes,4,7,16,52
6,73,Yes,4,2,8,60
4,87,No,8,8,12,71
5,59,No,5,9,14,45
6,93,Yes,5,9,15,82
3,76,No,9,9,12,57
8,66,No,7,5,13,63
4,61,No,5,3,7,41
8,90,No,6,7,15,84
3,44,Yes,9,3,6,24
7,73,No,8,3,10,63
9,78,Yes,6,7,16,79
4,42,No,4,3,7,20
8,56,No,7,0,8,50
3,63,Yes,6,5,8,43
7,63,No,8,7,14,56
3,42,Yes,6,2,5,21
7,84,Yes,6,1,8,76
6,46,Yes,5,5,11,34
2,64,Yes,7,0,2,42
3,95,Yes,4,4,7,78
6,42,Yes,8,5,11,28
4,54,Yes,9,7,11,39
6,68,No,9,6,12,56
1,89,Yes,8,5,6,63
1,68,No,4,1,2,38
3,49,No,8,7,10,29
8,71,No,5,7,15,67
8,62,Yes,9,4,12,57
4,78,Yes,9,2,6,63
6,48,No,6,7,13,38
8,76,Yes,5,4,12,68
7,91,No,9,2,9,82
7,79,No,5,8,15,70
4,53,No,5,8,12,32
9,43,Yes,4,6,15,43
6,59,No,9,7,13,49
3,67,Yes,7,4,7,49
5,53,No,4,4,9,36
5,83,Yes,4,4,9,69
5,73,No,5,1,6,57
8,52,Yes,7,2,10,47
9,70,No,4,7,16,69
9,72,Yes,7,5,14,65
6,91,Yes,9,8,14,84
6,78,Yes,5,6,12,66
9,67,No,4,5,14,60
4,64,No,7,3,7,44
6,71,No,8,6,12,61
4,48,Yes,4,3,7,30
1,67,Yes,4,6,7,39
7,97,No,4,4,11,85
6,70,No,7,1,7,58
9,56,Yes,6,6,15,53
7,92,No,9,7,14,86
7,62,Yes,4,9,16,55
2,52,Yes,8,1,3,32
9,94,Yes,8,5,14,94
9,49,No,5,3,12,41
6,55,Yes,6,4,10,43
3,45,No,6,0,3,25
1,87,Yes,7,5,6,64
4,50,No,5,7,11,37
3,97,No,7,1,4,79
1,91,Yes,5,0,1,62
3,42,Yes,9,8,11,21
4,67,Yes,6,1,5,49
8,80,Yes,9,7,15,77
9,54,No,7,4,13,50
3,99,No,5,1,4,79
6,52,No,6,4,10,35
5,81,No,6,8,13,66
6,91,No,4,5,11,74
4,95,Yes,7,2,6,77
6,84,Yes,4,7,13,72
7,56,No,6,0,7,48
9,46,Yes,7,8,17,42
7,67,Yes,7,8,15,59
6,77,Yes,9,3,9,66
1,52,Yes,8,7,8,27
2,99,Yes,5,2,4,75
1,56,Yes,8,5,6,31
9,54,No,8,9,18,51
9,75,Yes,6,9,18,74
7,67,Yes,9,7,14,63
2,54,No,5,8,10,31
6,85,No,8,7,13,79
4,92,No,8,8,12,77
1,50,Yes,7,3,4,26
1,95,No,6,9,10,69
5,70,Yes,8,0,5,56
2,43,No,5,6,8,18
4,74,Yes,4,9,13,55
1,73,Yes,4,3,4,45
4,91,No,6,0,4,74
6,66,Yes,4,2,8,56
4,49,Yes,7,6,10,34
1,69,Yes,7,2,3,44
7,84,Yes,5,0,7,73
2,59,No,9,6,8,38
9,68,No,6,7,16,64
3,97,No,6,4,7,75
8,92,Yes,4,5,13,84
8,68,No,8,2,10,62
3,62,No,8,4,7,41
4,96,Yes,9,2,6,81
2,89,No,8,1,3,66
4,60,No,9,6,10,45
9,87,No,5,9,18,84
2,82,Yes,6,6,8,60
3,49,No,4,7,10,26
4,80,No,5,0,4,64
5,51,No,7,1,6,32
1,69,Yes,7,1,2,48
7,90,Yes,7,2,9,83
7,72,No,9,6,13,62
9,57,No,9,6,15,55
4,53,No,6,6,10,36
6,61,Yes,7,0,6,52
2,60,Yes,9,1,3,35
4,40,No,9,7,11,21
2,88,No,8,8,10,67
5,82,Yes,9,9,14,71
7,91,Yes,7,6,13,87
1,99,No,5,0,1,70
7,54,Yes,7,3,10,43
6,75,No,8,9,15,69
6,86,No,7,7,13,75
8,93,Yes,4,4,12,85
8,61,No,8,0,8,56
6,71,No,6,6,12,55
3,97,No,7,5,8,78
5,85,No,9,8,13,71
2,93,No,5,3,5,68
5,72,No,7,3,8,60
9,97,No,5,7,16,95
1,80,Yes,4,3,4,51
5,98,Yes,6,2,7,84
6,78,No,9,6,12,68
7,62,Yes,8,4,11,54
9,82,No,8,8,17,79
6,94,No,6,4,10,83
5,41,Yes,4,8,13,28
7,41,No,4,5,12,31
1,77,No,7,5,6,50
5,94,Yes,4,5,10,79
2,90,Yes,7,6,8,64
4,68,Yes,5,3,7,53
7,91,Yes,6,3,10,81
5,85,Yes,5,8,13,70
6,99,Yes,5,6,12,85
2,42,No,5,9,11,20
3,78,Yes,5,5,8,60
7,46,Yes,8,0,7,36
2,75,No,4,6,8,49
6,68,No,6,5,11,56
5,94,Yes,6,3,8,79
1,76,No,9,7,8,53
4,88,No,5,6,10,70
2,97,No,6,7,9,74
4,75,No,7,8,12,60
1,62,No,6,0,1,32
2,84,No,5,2,4,59
8,55,No,6,1,9,48
6,87,Yes,4,2,8,74
2,70,No,5,1,3,46
6,73,Yes,8,5,11,63
9,89,No,4,8,17,87
7,40,No,6,1,8,29
9,57,Yes,8,3,12,51
5,97,No,9,4,9,81
7,79,No,4,4,11,70
7,82,Yes,9,0,7,75
3,95,No,7,5,8,75
7,95,No,4,4,11,85
1,54,Yes,8,5,6,28
9,87,Yes,9,3,12,84
6,88,No,7,5,11,76
5,56,Yes,9,8,13,43
7,83,No,6,0,7,73
5,49,No,5,5,10,33
5,59,Yes,9,0,5,45
7,45,Yes,6,6,13,38
7,47,Yes,5,3,10,39
3,84,Yes,5,5,8,67
3,73,No,8,6,9,53
3,71,Yes,7,4,7,50
6,90,Yes,7,8,14,80
6,93,No,4,7,13,80
3,81,No,6,2,5,60
3,43,No,8,0,3,23
8,83,No,9,9,17,80
8,89,No,6,7,15,83
7,78,No,9,3,10,72
4,59,No,9,6,10,46
4,63,No,9,3,7,45
3,63,No,4,6,9,42
5,94,Yes,4,0,5,78
3,65,Yes,8,0,3,43
8,64,No,4,1,9,55
7,75,Yes,8,4,11,67
3,46,No,4,9,12,28
9,49,No,7,5,14,48
5,97,No,8,1,6,81
9,86,No,7,0,9,84
7,51,Yes,7,8,15,41
7,40,Yes,8,6,13,31
6,91,No,6,7,13,83
2,89,Yes,5,5,7,70
9,64,Yes,4,8,17,57
6,55,No,9,7,13,45
8,44,No,4,3,11,37
1,58,Yes,9,4,5,33
5,43,Yes,6,1,6,28
1,45,No,5,0,1,16
8,65,No,6,5,13,60
8,88,Yes,5,2,10,81
1,78,No,8,3,4,54
9,95,No,8,0,9,94
2,94,No,9,5,7,74
9,78,Yes,7,7,16,76
1,48,Yes,7,9,10,19
9,84,No,9,3,12,83
4,91,Yes,8,9,13,73
9,53,No,9,7,16,52
7,87,Yes,7,9,16,81
6,94,Yes,9,2,8,84
5,48,Yes,8,6,11,35
9,54,No,6,2,11,53
2,76,No,4,5,7,55
2,89,No,8,3,5,66
9,92,Yes,9,5,14,87
3,59,No,8,6,9,43
8,47,No,8,7,15,39
9,71,No,7,5,14,68
8,86,No,9,3,11,81
4,60,Yes,7,8,12,45
1,96,No,9,6,7,75
4,80,No,7,8,12,64
9,58,Yes,7,2,11,54
2,68,No,6,4,6,45
3,97,Yes,8,0,3,75
8,70,Yes,6,7,15,64
6,93,Yes,7,0,6,81
8,45,No,6,0,8,39
7,43,Yes,8,6,13,38
5,82,Yes,8,7,12,72
9,68,Yes,7,2,11,67
4,81,No,8,1,5,66
6,42,Yes,6,6,12,32
2,40,Yes,5,9,11,17
2,83,Yes,8,4,6,59
2,94,No,6,0,2,70
7,54,Yes,6,1,8,41
2,86,Yes,6,2,4,62
2,60,No,8,5,7,38
9,85,No,5,0,9,81
7,97,No,7,7,14,88
3,70,Yes,7,1,4,46
3,46,Yes,8,4,7,25
7,56,Yes,8,7,14,48
5,95,Yes,4,4,9,81
6,58,No,9,7,13,49
8,78,Yes,5,5,13,72
9,99,No,6,6,15,96
1,42,Yes,9,7,8,17
3,69,Yes,6,2,5,48
7,74,Yes,9,4,11,69
6,97,No,7,9,15,85
7,96,No,9,6,13,85
8,68,No,8,8,16,64
6,89,No,5,5,11,79
3,91,Yes,7,9,12,74
2,93,Yes,9,0,2,69
7,53,Yes,5,7,14,44
1,74,Yes,8,5,6,50
3,67,Yes,6,0,3,48
4,97,No,4,3,7,77
1,69,No,5,5,6,46
5,65,Yes,6,9,14,51
3,46,Yes,5,0,3,23
2,78,Yes,5,9,11,56
3,70,Yes,5,4,7,47
8,44,No,8,2,10,42
6,74,Yes,7,6,12,64
7,89,Yes,5,7,14,80
6,86,Yes,8,2,8,73
6,91,Yes,4,9,15,80
3,53,No,7,2,5,34
8,75,Yes,8,2,10,69
7,66,No,4,5,12,54
7,63,No,7,5,12,56
6,79,Yes,8,2,8,66
5,68,Yes,4,5,10,53
8,92,Yes,8,8,16,89
5,84,Yes,4,7,12,70
9,61,Yes,5,6,15,59
9,47,No,5,6,15,41
1,54,No,7,7,8,28
6,88,No,4,6,12,75
7,44,No,5,2,9,34
3,91,No,7,7,10,68
7,43,Yes,6,7,14,32
7,50,Yes,5,0,7,44
2,57,No,5,9,11,35
7,81,Yes,9,4,11,74
1,88,Yes,8,4,5,64
5,69,No,6,0,5,57
9,54,No,4,5,14,46
7,45,No,7,5,12,36
7,94,Yes,6,3,10,85
2,92,No,4,5,7,71
8,55,No,5,5,13,49
3,86,Yes,9,0,3,71
8,79,Yes,7,4,12,76
3,48,No,7,1,4,26
7,82,Yes,6,6,13,74
2,98,No,8,8,10,78
4,73,Yes,4,8,12,59
6,66,No,9,8,14,55
9,52,Yes,9,6,15,51
5,75,Yes,6,6,11,57
9,66,Yes,8,0,9,63
5,48,No,8,5,10,37
8,44,No,8,4,12,41
1,90,No,7,7,8,67
7,61,Yes,4,7,14,56
4,70,Yes,4,3,7,51
5,42,Yes,6,0,5,26
6,69,No,5,5,11,56
5,60,Yes,6,9,14,48
1,74,No,4,0,1,52
9,45,No,7,4,13,42
2,67,No,6,4,6,41
9,71,No,5,2,11,64
2,81,No,9,4,6,57
9,76,Yes,6,5,14,72
6,64,Yes,8,4,10,52
9,71,Yes,5,0,9,67
6,74,Yes,8,6,12,61
6,61,Yes,7,2,8,51
2,63,Yes,4,6,8,42
8,78,No,6,4,12,71
3,93,Yes,6,2,5,74
7,69,No,8,5,12,62
5,89,No,8,0,5,76
3,71,No,4,5,8,50
1,70,No,6,3,4,42
8,62,No,4,3,11,55
3,79,Yes,8,4,7,60
2,72,Yes,9,8,10,52
1,64,Yes,8,0,1,36
4,75,No,5,2,6,53
8,63,Yes,8,3,11,54
3,70,Yes,8,1,4,47
1,97,No,9,8,9,70
4,78,No,4,6,10,62
9,85,Yes,5,0,9,82
1,52,No,5,8,9,26
2,49,No,6,5,7,25
9,62,No,9,1,10,55
2,57,Yes,7,0,2,34
3,71,No,6,5,8,51
7,72,No,6,6,13,63
3,75,No,6,9,12,54
9,67,No,5,5,14,62
6,55,No,4,6,12,43
3,55,Yes,8,5,8,34
9,57,Yes,5,7,16,56
1,47,No,8,1,2,24
3,81,No,8,8,11,65
1,55,Yes,7,8,9,31
2,94,Yes,6,8,10,72
8,95,No,7,6,14,90
7,50,No,6,8,15,43
2,45,Yes,5,0,2,23
2,40,No,8,2,4,18
9,51,No,7,1,10,44
6,96,Yes,9,0,6,84
5,77,Yes,5,4,9,62
6,67,Yes,5,0,6,56
9,84,Yes,9,2,11,87
7,97,No,6,5,12,89
9,56,No,8,5,14,55
4,40,No,6,2,6,18
2,71,No,6,3,5,46
8,47,Yes,5,6,14,42
4,93,Yes,6,5,9,72
9,79,No,4,1,10,75
4,95,No,9,8,12,79
8,82,No,9,5,13,78
9,85,Yes,8,1,10,81
9,63,Yes,9,6,15,63
4,49,Yes,6,9,13,35
1,86,No,6,9,10,63
3,78,No,7,3,6,59
9,78,No,8,0,9,76
4,49,Yes,8,9,13,33
5,75,No,9,8,13,62
7,64,Yes,6,9,16,58
5,99,No,4,7,12,82
4,89,No,7,4,8,73
2,98,Yes,4,2,4,75
2,96,Yes,6,3,5,71
4,49,No,8,2,6,30
9,58,Yes,8,9,18,58
8,85,Yes,4,7,15,80
3,84,Yes,5,4,7,65
9,54,Yes,6,7,16,51
5,55,Yes,8,0,5,44
3,41,No,9,8,11,23
5,68,No,5,9,14,56
4,43,No,8,2,6,25
8,92,No,9,0,8,89
5,89,Yes,8,2,7,75
8,68,No,5,1,9,60
9,70,Yes,4,6,15,64
4,56,No,6,9,13,40
7,49,No,5,3,10,37
2,66,Yes,5,6,8,42
6,92,No,8,2,8,78
8,80,No,9,5,13,72
7,54,No,5,6,13,44
7,99,No,6,6,13,89
8,83,No,4,4,12,77
7,70,No,9,5,12,62
5,60,No,4,2,7,46
7,99,Yes,4,3,10,94
3,98,No,6,5,8,80
5,97,No,8,2,7,83
7,80,No,9,6,13,74
9,85,No,9,2,11,85
2,84,No,6,8,10,61
4,99,No,9,3,7,85
7,65,Yes,5,1,8,58
1,77,No,7,5,6,52
2,90,No,7,8,10,69
9,75,Yes,7,9,18,78
7,91,Yes,4,9,16,82
7,56,No,9,1,8,47
6,90,No,6,3,9,79
3,42,No,9,4,7,21
3,53,Yes,6,8,11,33
2,88,Yes,9,6,8,65
6,52,No,4,4,10,35
4,80,No,5,5,9,63
5,66,Yes,7,8,13,50
3,40,Yes,7,3,6,18
6,96,Yes,9,1,7,88
3,56,Yes,4,4,7,35
8,87,No,7,6,14,82
9,89,Yes,9,3,12,87
4,73,Yes,8,0,4,59
9,53,No,9,7,16,56
7,93,Yes,6,4,11,86
3,94,No,7,9,12,70
7,98,Yes,7,1,8,90
1,56,No,8,2,3,28
3,42,Yes,5,9,12,21
6,73,No,9,9,15,64
4,79,No,5,4,8,61
7,64,Yes,9,3,10,54
3,41,No,8,8,11,20
1,73,No,5,8,9,49
9,65,Yes,4,7,16,65
6,70,No,8,1,7,61
8,48,No,9,4,12,40
3,69,Yes,6,7,10,49
8,59,Yes,6,7,15,52
2,60,No,6,6,8,38
4,68,No,9,3,7,51
3,98,No,7,2,5,76
1,64,No,8,7,8,42
7,77,No,8,7,14,68
2,97,Yes,5,9,11,77
4,83,No,8,4,8,65
9,64,Yes,8,2,11,63
6,48,Yes,5,4,10,35
8,78,Yes,8,3,11,71
2,83,Yes,8,7,9,64
7,65,No,4,1,8,53
6,96,No,9,7,13,87
9,76,No,5,9,18,71
7,55,Yes,4,5,12,43
1,76,Yes,7,3,4,54
8,51,No,5,2,10,44
3,63,Yes,9,9,12,45
2,65,No,8,4,6,42
3,59,Yes,8,5,8,38
6,48,Yes,4,0,6,36
3,62,Yes,4,0,3,43
5,78,Yes,7,9,14,67
6,68,Yes,7,2,8,58
8,70,Yes,9,1,9,64
7,58,Yes,8,0,7,51
8,59,No,6,7,15,57
3,62,No,7,0,3,40
4,82,Yes,8,9,13,68
6,66,Yes,7,7,13,58
7,69,No,5,4,11,63
9,60,Yes,4,3,12,56
1,83,No,8,7,8,60
8,74,No,7,7,15,68
8,88,No,4,7,15,82
6,46,No,6,2,8,33
4,61,No,7,7,11,47
3,49,Yes,8,0,3,32
3,62,Yes,5,3,6,39
6,54,No,4,4,10,41
8,69,Yes,4,5,13,61
7,73,No,5,4,11,63
1,52,Yes,8,4,5,27
6,99,Yes,9,4,10,88
7,43,Yes,6,8,15,35
7,57,Yes,9,9,16,48
9,95,Yes,5,9,18,95
5,62,Yes,6,2,7,48
1,72,Yes,8,1,2,45
2,73,Yes,7,9,11,49
4,73,No,7,1,5,57
5,75,No,9,7,12,61
9,74,Yes,8,4,13,75
1,56,Yes,6,4,5,26
3,67,Yes,9,5,8,47
5,53,No,5,8,13,37
3,73,Yes,9,6,9,55
4,87,Yes,8,4,8,73
3,50,No,8,4,7,30
4,96,No,7,9,13,80
1,52,No,5,8,9,24
8,72,Yes,7,8,16,66
4,96,No,6,1,5,77
7,94,Yes,6,6,13,86
2,41,No,4,9,11,13
2,73,Yes,8,0,2,52
6,92,Yes,5,3,9,80
2,68,Yes,5,1,3,44
6,76,No,7,9,15,68
2,43,Yes,9,8,10,23
4,51,Yes,9,5,9,36
7,65,Yes,7,3,10,58
8,97,No,9,2,10,91
3,67,Yes,5,3,6,48
9,42,Yes,7,1,10,40
2,59,Yes,9,4,6,33
8,49,Yes,4,8,16,46
8,91,No,8,5,13,87
4,57,Yes,4,1,5,39
1,92,No,9,5,6,70
1,92,No,6,8,9,67
2,92,Yes,5,3,5,68
9,66,No,4,0,9,61
2,70,No,4,1,3,51
2,66,No,7,4,6,43
6,81,Yes,7,9,15,70
7,40,No,7,6,13,34
7,45,No,9,7,14,33
9,50,Yes,6,2,11,46
6,73,Yes,4,8,14,60
8,78,No,8,1,9,73
6,59,No,7,3,9,47
2,92,No,6,3,5,67
1,60,Yes,9,5,6,37
5,60,No,6,9,14,44
9,57,Yes,7,5,14,55
8,60,No,5,2,10,52
4,58,No,4,8,12,42
5,43,Yes,7,4,9,28
5,52,No,8,1,6,31
6,57,Yes,4,5,11,42
3,91,No,6,2,5,71
5,68,Yes,8,7,12,54
2,64,Yes,4,2,4,42
1,95,No,8,4,5,68
1,52,Yes,6,3,4,27
7,66,No,7,3,10,59
2,99,Yes,8,1,3,77
4,58,Yes,7,7,11,43
5,88,Yes,6,2,7,73
7,40,No,6,3,10,31
2,77,Yes,8,5,7,55
6,58,Yes,8,8,14,49
1,91,Yes,6,3,4,65
7,40,No,8,2,9,30
9,79,No,8,4,13,75
5,56,Yes,8,8,13,43
5,60,Yes,9,0,5,49
4,61,No,8,4,8,44
3,54,Yes,4,3,6,35
9,89,Yes,6,4,13,88
5,78,Yes,6,6,11,65
8,87,Yes,5,6,14,82
9,78,Yes,7,6,15,76
5,71,Yes,5,0,5,54
9,88,No,8,8,17,90
2,43,Yes,8,6,8,23
9,83,Yes,4,3,12,79
4,84,No,4,3,7,65
6,71,No,4,1,7,59
6,43,No,4,5,11,28
6,92,No,4,9,15,79
2,40,Yes,4,2,4,11
7,72,No,4,0,7,61
6,46,Yes,4,4,10,36
1,48,No,9,5,6,22
2,40,No,4,4,6,20
7,55,No,6,4,11,45
1,57,Yes,4,9,10,32
1,93,No,7,7,8,68
1,86,No,4,9,10,55
8,45,No,9,0,8,38
4,41,Yes,8,7,11,23
4,48,Yes,9,6,10,33
2,43,No,9,0,2,22
1,84,Yes,8,8,9,60
9,62,No,4,3,12,58
7,93,Yes,4,6,13,84
4,82,No,8,2,6,67
6,84,Yes,7,7,13,79
2,82,No,5,3,5,61
7,90,Yes,6,1,8,80
2,47,Yes,8,1,3,27
8,78,No,4,7,15,72
8,64,No,6,7,15,61
1,55,Yes,4,0,1,25
8,74,No,5,5,13,67
2,56,No,5,8,10,33
6,57,No,8,8,14,46
1,99,No,6,1,2,73
5,66,Yes,9,7,12,54
7,54,No,6,7,14,44
1,99,Yes,9,3,4,74
2,56,Yes,5,3,5,31
7,82,No,4,4,11,73
6,44,No,9,9,15,34
3,55,Yes,9,6,9,36
2,54,No,8,0,2,27
4,81,No,7,8,12,66
3,85,Yes,5,2,5,66
7,73,Yes,9,3,10,64
8,87,Yes,5,6,14,82
2,58,No,8,4,6,34
7,47,No,4,4,11,38
8,86,Yes,6,0,8,79
6,49,Yes,5,1,7,35
6,44,No,8,4,10,33
1,91,No,8,1,2,65
4,87,No,8,0,4,69
1,92,Yes,6,9,10,66
4,65,No,5,2,6,45
2,61,No,9,0,2,37
5,83,Yes,8,9,14,71
9,62,No,6,7,16,59
3,52,Yes,4,7,10,32
8,48,No,7,7,15,40
3,88,Yes,5,6,9,73
6,59,Yes,6,6,12,48
4,67,Yes,7,1,5,52
8,83,No,7,8,16,79
6,96,No,6,6,12,85
8,76,No,9,4,12,72
1,63,No,9,3,4,39
6,83,Yes,6,7,13,72
1,72,No,6,4,5,51
1,59,No,8,5,6,36
8,99,Yes,4,3,11,89
7,87,Yes,9,1,8,82
3,69,Yes,8,6,9,51
6,83,Yes,7,1,7,75
9,48,No,7,6,15,44
7,84,Yes,7,6,13,72
3,88,No,6,0,3,66
6,56,No,5,9,15,41
4,75,Yes,8,9,13,59
3,53,Yes,5,2,5,31
9,58,Yes,4,2,11,54
2,46,Yes,4,5,7,23
1,98,Yes,8,2,3,75
2,42,No,7,8,10,21
7,72,Yes,9,4,11,69
1,83,No,4,5,6,56
6,71,Yes,5,5,11,60
7,86,No,5,7,14,79
9,50,No,9,9,18,47
8,81,No,6,2,10,72
6,41,Yes,7,8,14,31
3,65,Yes,6,6,9,45
8,43,Yes,8,5,13,40
7,56,No,4,0,7,46
3,56,No,9,3,6,38
9,67,Yes,9,4,13,64
2,69,Yes,9,1,3,46
3,79,No,6,0,3,58
2,62,No,6,1,3,37
1,85,Yes,8,7,8,62
4,63,Yes,5,9,13,49
5,68,Yes,5,5,10,53
6,43,No,8,9,15,30
5,77,No,9,1,6,59
1,68,Yes,5,8,9,40
3,58,Yes,8,7,10,37
1,66,Yes,5,3,4,41
5,68,Yes,8,9,14,56
5,95,Yes,5,6,11,81
6,75,No,9,2,8,66
8,74,Yes,6,5,13,71
1,91,No,6,2,3,64
4,45,No,9,9,13,31
1,98,No,5,2,3,72
9,62,No,9,8,17,57
7,78,No,8,5,12,67
7,85,No,6,7,14,76
5,83,No,4,3,8,68
7,87,No,5,3,10,78
2,91,Yes,4,7,9,68
4,47,Yes,4,6,10,25
7,94,Yes,7,4,11,86
3,41,Yes,4,1,4,15
2,52,Yes,4,5,7,28
2,79,No,9,0,2,58
1,96,No,7,6,7,72
5,60,No,7,8,13,45
6,70,No,7,4,10,59
6,91,No,8,4,10,78
9,87,Yes,7,6,15,84
4,75,Yes,9,4,8,56
1,87,No,8,9,10,62
6,91,Yes,5,3,9,78
5,77,Yes,8,0,5,62
6,66,Yes,5,5,11,54
3,75,Yes,7,8,11,57
2,87,Yes,7,3,5,61
6,62,No,5,9,15,49
1,94,Yes,6,3,4,71
7,60,Yes,9,4,11,55
7,52,No,8,5,12,44
7,76,No,9,2,9,68
1,86,No,9,8,9,60
4,65,No,4,0,4,45
7,79,No,7,5,12,72
9,46,No,8,5,14,41
5,85,No,9,7,12,73
2,78,No,8,4,6,57
7,61,Yes,9,8,15,55
1,78,No,7,8,9,53
7,62,No,9,1,8,53
6,97,Yes,5,4,10,87
7,69,No,7,6,13,61
3,57,No,8,1,4,38
3,81,No,6,6,9,60
7,57,No,9,8,15,49
2,85,Yes,5,7,9,64
1,49,Yes,7,9,10,23
9,78,No,4,8,17,72
9,69,Yes,7,3,12,71
7,65,Yes,8,7,14,59
7,46,Yes,8,8,15,38
3,46,Yes,4,9,12,24
2,44,Yes,5,1,3,18
7,40,Yes,8,9,16,33
9,85,No,5,2,11,81
1,57,No,5,0,1,30
4,52,Yes,7,0,4,32
6,64,Yes,5,9,15,50
7,79,Yes,9,5,12,73
7,47,No,8,0,7,38
2,49,No,8,4,6,28
4,71,No,6,5,9,57
5,56,No,5,8,13,41
1,77,No,6,5,6,52
1,54,No,7,3,4,26
3,54,Yes,6,0,3,28
3,96,No,5,5,8,74
8,87,No,8,6,14,81
9,79,No,7,4,13,81
1,90,Yes,5,5,6,61
2,59,No,7,9,11,38
2,54,Yes,4,7,9,29
4,74,Yes,5,0,4,57
2,45,No,4,7,9,21
7,69,No,6,1,8,57
9,96,No,5,1,10,94
7,47,Yes,4,7,14,39
6,70,No,9,1,7,59
1,87,Yes,8,7,8,64
9,86,Yes,6,4,13,83
5,71,No,5,8,13,53
5,84,No,5,8,13,70
6,97,No,8,7,13,92
9,91,Yes,8,8,17,92
8,54,No,4,6,14,47
8,57,Yes,4,7,15,51
8,52,No,4,5,13,45
1,63,Yes,7,8,9,34
1,79,No,6,1,2,50
8,53,No,5,2,10,45
5,67,Yes,6,1,6,54
9,50,Yes,8,5,14,52
2,45,No,9,2,4,20
9,95,Yes,6,0,9,93
8,64,Yes,6,3,11,53
9,40,Yes,4,4,13,35
4,64,Yes,8,3,7,48
1,41,No,6,5,6,18
1,71,Yes,5,2,3,43
5,52,No,4,9,14,36
2,72,No,6,5,7,51
8,71,No,8,9,17,65
5,95,Yes,9,0,5,81
5,63,No,5,5,10,45
2,66,No,9,7,9,46
7,43,No,8,9,16,32
8,63,No,8,7,15,60
1,62,No,8,0,1,33
2,68,Yes,9,6,8,45
4,73,No,7,9,13,54
5,60,Yes,5,9,14,46
2,69,No,8,3,5,49
1,65,No,7,5,6,38
9,59,Yes,4,5,14,53
1,55,Yes,7,4,5,30
4,42,No,4,9,13,24
2,88,No,9,8,10,69
4,76,No,7,9,13,57
8,97,No,9,7,15,94
8,79,No,8,5,13,77
9,83,Yes,7,3,12,79
5,64,No,7,3,8,50
7,62,No,8,8,15,52
3,83,Yes,4,3,6,64
4,98,Yes,8,6,10,86
9,40,No,5,5,14,33
1,72,Yes,7,1,2,47
2,54,Yes,5,4,6,31
5,56,Yes,8,2,7,42
3,73,No,9,8,11,54
2,56,No,8,9,11,33
1,91,No,6,0,1,61
3,97,Yes,5,9,12,78
1,80,No,6,3,4,55
1,83,No,5,3,4,59
1,43,Yes,9,8,9,20
8,52,No,6,0,8,43
3,43,Yes,6,1,4,19
1,46,Yes,5,0,1,17
7,85,Yes,8,0,7,73
3,98,Yes,4,0,3,72
8,48,No,8,2,10,39
4,62,No,4,3,7,44
4,72,No,5,9,13,52
5,72,Yes,7,1,6,58
6,59,No,8,0,6,45
7,43,No,6,4,11,36
4,40,Yes,8,5,9,22
8,93,Yes,5,1,9,86
6,81,No,7,2,8,68
1,73,Yes,7,9,10,47
1,66,No,8,2,3,40
9,60,Yes,8,1,10,58
6,63,Yes,9,3,9,53
8,54,No,8,4,12,46
7,74,Yes,5,7,14,66
6,64,Yes,4,5,11,49
4,94,Yes,9,8,12,77
7,48,No,4,2,9,36
9,56,No,6,9,18,55
7,60,No,5,8,15,49
1,99,Yes,9,3,4,76
9,52,Yes,7,7,16,45
4,42,Yes,9,9,13,28
3,43,Yes,6,6,9,25
4,43,No,7,6,10,27
4,82,No,9,8,12,67
2,67,Yes,7,9,11,44
1,46,No,8,1,2,18
1,65,No,7,4,5,37
8,50,No,9,2,10,43
2,63,Yes,7,6,8,43
5,82,No,5,2,7,66
4,49,No,8,4,8,34
8,76,No,8,4,12,77
2,52,No,6,1,3,31
9,83,No,8,0,9,80
7,81,Yes,4,5,12,71
7,78,No,5,0,7,69
1,58,No,6,8,9,34
2,90,Yes,4,9,11,69
4,58,No,7,4,8,44
4,51,Yes,4,0,4,30
3,91,Yes,6,7,10,73
7,61,Yes,8,0,7,52
8,86,Yes,5,3,11,81
2,76,No,6,6,8,52
4,95,No,4,3,7,77
3,69,Yes,4,4,7,44
2,85,No,6,6,8,62
6,51,Yes,9,3,9,44
4,68,No,9,4,8,51
6,60,No,6,6,12,48
2,50,Yes,9,0,2,30
4,99,No,6,2,6,82
6,76,Yes,8,0,6,61
5,87,No,6,2,7,72
3,97,No,7,1,4,78
8,57,No,5,4,12,53
7,83,Yes,5,9,16,78
3,98,Yes,7,4,7,79
6,66,Yes,4,9,15,56
4,76,No,4,8,12,58
5,87,Yes,4,7,12,72
5,51,Yes,4,2,7,37
7,62,Yes,8,0,7,56
5,73,No,7,4,9,59
3,77,No,5,2,5,54
5,62,No,7,4,9,47
7,92,No,5,8,15,84
5,64,Yes,4,0,5,50
5,43,No,8,0,5,27
9,69,Yes,6,8,17,67
3,69,No,6,2,5,48
6,52,Yes,9,9,15,42
1,81,Yes,4,4,5,55
5,88,No,4,8,13,73
8,53,Yes,7,4,12,46
5,95,Yes,8,2,7,81
9,86,Yes,8,8,17,82
6,47,Yes,7,6,12,35
8,94,No,8,6,14,92
8,63,No,8,7,15,59
3,57,Yes,6,4,7,35
7,74,No,8,1,8,65
7,64,Yes,4,8,15,53
6,56,Yes,6,2,8,45
7,71,No,4,1,8,61
2,95,Yes,4,9,11,74
9,63,No,7,9,18,60
1,46,Yes,9,4,5,23
1,52,No,8,7,8,25
3,66,No,8,2,5,45
3,87,Yes,8,5,8,68
1,44,No,8,8,9,21
7,75,Yes,6,1,8,65
4,65,No,5,7,11,45
2,81,Yes,4,9,11,58
5,84,No,9,6,11,76
6,70,No,9,2,8,57
9,49,No,5,0,9,46
4,85,Yes,5,5,9,68
2,65,No,5,1,3,40
5,61,Yes,6,2,7,45
3,51,No,5,4,7,31
2,71,No,6,7,9,50
1,66,Yes,7,1,2,43
2,72,No,7,5,7,50
6,92,Yes,9,0,6,80
8,91,Yes,7,6,14,90
3,59,Yes,6,3,6,38
9,78,Yes,6,0,9,73
9,80,Yes,4,8,17,78
2,79,No,5,8,10,54
8,98,Yes,8,2,10,92
5,52,No,8,5,10,39
4,53,Yes,5,6,10,41
5,83,Yes,8,3,8,71
4,79,No,8,5,9,65
8,92,No,8,8,16,87
4,61,Yes,9,9,13,47
6,57,Yes,6,5,11,42
2,87,No,6,6,8,62
5,68,No,6,5,10,54
6,82,Yes,5,6,12,71
5,55,Yes,7,0,5,42
2,85,Yes,9,5,7,64
7,74,No,9,8,15,70
4,92,Yes,8,2,6,77
8,73,No,4,5,13,62
7,42,No,6,3,10,28
7,43,Yes,9,6,13,36
9,93,Yes,9,6,15,92
1,44,No,4,8,9,18
6,49,Yes,8,3,9,37
6,91,Yes,9,7,13,81
6,68,No,9,7,13,57
6,71,Yes,7,7,13,61
7,70,No,4,7,14,62
6,41,No,8,5,11,27
1,51,Yes,8,7,8,26
3,66,No,6,5,8,48
2,44,No,7,9,11,18
6,76,Yes,8,1,7,66
8,66,No,7,2,10,59
3,62,Yes,6,5,8,41
8,72,No,4,6,14,64
8,43,No,9,3,11,40
5,98,No,9,0,5,84
8,60,No,5,3,11,51
6,63,No,5,5,11,49
5,83,No,5,7,12,67
9,70,No,9,3,12,70
7,83,Yes,7,9,16,75
8,87,No,5,0,8,80
1,63,Yes,4,4,5,35
2,88,No,8,6,8,65
8,92,No,7,5,13,86
9,49,Yes,9,2,11,45
4,88,Yes,4,6,10,69
9,88,Yes,9,3,12,86
4,89,No,7,4,8,75
9,41,Yes,7,6,15,39
7,70,No,7,1,8,59
2,64,No,6,3,5,42
9,43,Yes,8,3,12,42
4,90,No,5,5,9,70
8,50,Yes,6,6,14,48
7,56,Yes,8,3,10,49
7,83,Yes,9,9,16,78
8,41,Yes,5,0,8,34
1,45,No,6,0,1,18
5,48,No,6,4,9,33
2,44,Yes,4,0,2,20
2,59,Yes,6,2,4,35
1,68,No,7,8,9,46
5,60,No,9,2,7,42
2,48,Yes,6,2,4,23
4,67,No,7,8,12,51
3,94,No,8,4,7,75
3,47,No,8,7,10,27
2,70,No,7,9,11,48
6,59,Yes,4,8,14,45
2,66,No,4,5,7,40
8,47,Yes,8,6,14,42
8,93,Yes,9,6,14,90
5,60,Yes,6,6,11,45
7,67,No,8,3,10,55
4,62,No,8,1,5,45
1,45,Yes,7,1,2,20
2,42,No,4,6,8,15
4,44,Yes,9,9,13,28
1,48,Yes,7,6,7,25
8,46,No,8,9,17,39
9,99,No,5,6,15,96
4,43,No,6,7,11,24
3,78,Yes,8,2,5,63
2,44,Yes,7,4,6,19
5,50,No,5,5,10,31
3,54,Yes,5,7,10,35
7,73,Yes,8,7,14,65
6,52,Yes,9,9,15,41
1,93,No,4,2,3,65
8,87,No,5,3,11,83
2,46,No,6,5,7,22
5,79,Yes,7,3,8,68
9,45,No,7,9,18,40
8,95,Yes,7,3,11,92
2,78,Yes,8,4,6,54
9,89,Yes,7,9,18,90
5,69,No,7,6,11,57
6,61,Yes,6,1,7,47
3,64,No,4,1,4,43
3,67,Yes,9,9,12,50
8,93,No,8,8,16,91
2,59,No,8,3,5,34
2,78,No,7,4,6,54
5,42,No,6,2,7,26
6,44,No,5,1,7,34
2,40,No,7,9,11,18
5,54,No,7,7,12,38
7,65,No,8,3,10,57
8,42,Yes,8,0,8,34
7,79,Yes,7,5,12,68
8,96,Yes,8,5,13,92
9,80,Yes,6,1,10,77
5,86,Yes,5,1,6,71
5,81,No,5,7,12,67
4,73,No,5,6,10,59
9,91,No,7,1,10,91
5,44,No,9,9,14,29
2,70,No,7,0,2,48
8,90,Yes,7,7,15,90
7,52,Yes,6,9,16,48
8,82,No,5,1,9,77
3,40,Yes,8,4,7,20
4,61,Yes,8,5,9,42
5,54,No,4,9,14,37
6,65,No,4,0,6,52
1,57,Yes,9,1,2,33
4,87,Yes,8,9,13,72
5,48,No,5,3,8,34
7,40,Yes,7,1,8,33
5,82,No,8,5,10,71
1,48,Yes,9,3,4,25
7,62,Yes,9,2,9,55
8,82,No,8,5,13,76
7,84,Yes,4,8,15,76
4,97,No,5,7,11,81
8,41,Yes,8,1,9,35
5,53,Yes,7,2,7,35
9,77,No,7,1,10,74
5,79,Yes,6,9,14,66
1,57,No,7,6,7,31
9,55,No,8,8,17,54
5,92,Yes,8,0,5,79
6,68,No,7,2,8,58
4,83,No,4,5,9,66
6,50,No,5,3,9,36
8,45,Yes,9,9,17,44
3,42,No,8,9,12,26
5,53,No,7,0,5,37
2,99,Yes,9,8,10,82
2,41,No,7,6,8,18
7,71,No,8,6,13,66
6,70,No,6,0,6,60
4,50,Yes,5,8,12,32
5,61,Yes,8,7,12,51
1,42,Yes,9,9,10,18
7,89,Yes,7,4,11,82
8,70,Yes,6,3,11,66
9,72,Yes,8,0,9,69
8,63,No,5,8,16,59
5,40,Yes,6,7,12,26
3,83,Yes,9,1,4,63
9,54,Yes,7,3,12,52
6,76,Yes,4,3,9,66
5,66,No,5,6,11,51
3,77,No,6,2,5,54
6,87,Yes,8,7,13,77
3,66,No,8,6,9,45
6,83,Yes,6,9,15,77
4,51,No,8,3,7,32
2,42,Yes,6,8,10,15
8,69,Yes,5,5,13,62
4,71,Yes,8,2,6,55
9,62,Yes,5,6,15,59
7,41,No,7,5,12,32
2,46,Yes,7,7,9,21
4,73,No,7,4,8,56
5,71,No,7,5,10,55
3,92,No,8,0,3,74
9,78,Yes,6,7,16,74
5,71,No,8,0,5,56
2,82,No,9,2,4,58
3,82,No,8,1,4,64
9,53,Yes,5,5,14,49
7,42,No,6,7,14,31
2,85,Yes,4,7,9,64
9,71,No,4,6,15,63
4,82,No,6,6,10,66
9,75,Yes,4,7,16,73
2,56,Yes,6,4,6,38
4,87,No,5,2,6,70
5,42,Yes,5,1,6,27
2,96,No,8,2,4,72
1,49,No,4,2,3,21
7,92,Yes,6,6,13,85
1,86,Yes,5,0,1,62
8,79,Yes,8,6,14,73
3,57,No,4,5,8,32
6,42,No,4,9,15,30
7,78,No,4,1,8,64
1,49,Yes,5,9,10,25
6,91,Yes,5,0,6,82
7,48,Yes,4,8,15,41
6,85,No,5,1,7,71
4,94,Yes,4,3,7,79
1,85,Yes,7,8,9,59
9,50,No,5,8,17,45
4,99,Yes,6,0,4,84
7,72,Yes,5,1,8,62
7,75,No,4,1,8,65
2,65,No,6,1,3,43
1,66,No,8,7,8,39
8,77,No,6,7,15,70
8,61,No,6,9,17,54
7,65,No,5,7,14,55
8,61,Yes,9,3,11,55
3,44,Yes,6,7,10,25
2,74,No,6,6,8,52
7,41,No,4,7,14,31
8,74,Yes,5,0,8,68
1,48,No,4,2,3,19
9,90,No,5,9,18,87
4,90,Yes,8,5,9,71
4,88,Yes,9,0,4,74
3,57,No,6,3,6,35
6,82,No,5,8,14,69
1,51,Yes,6,6,7,24
6,42,No,6,0,6,29
2,57,Yes,7,5,7,34
9,95,Yes,4,5,14,93
2,77,No,9,1,3,52
7,46,Yes,5,5,12,37
1,72,Yes,8,9,10,49
7,45,Yes,9,1,8,38
5,57,No,7,7,12,44
8,84,No,4,6,14,75
4,61,No,8,5,9,44
7,90,Yes,8,9,16,84
6,78,Yes,6,5,11,65
5,90,No,4,8,13,75
4,48,Yes,7,8,12,29
7,74,Yes,5,9,16,67
5,62,No,5,9,14,50
5,51,Yes,7,1,6,38
1,91,Yes,6,2,3,66
2,63,Yes,6,9,11,42
5,89,Yes,8,6,11,76
3,79,Yes,4,9,12,64
2,48,Yes,8,8,10,26
4,52,No,5,5,9,31
4,79,No,7,0,4,63
4,93,Yes,4,6,10,77
4,81,No,7,0,4,61
3,56,No,4,4,7,33
7,46,No,9,8,15,39
9,56,Yes,5,9,18,52
5,94,No,5,9,14,82
4,89,Yes,9,8,12,73
2,63,No,4,0,2,37
2,41,No,6,5,7,16
5,74,Yes,4,2,7,59
7,67,No,5,8,15,59
9,58,Yes,7,2,11,56
7,72,No,8,1,8,59
5,60,No,7,7,12,46
6,92,No,5,2,8,80
3,49,No,7,4,7,30
5,92,Yes,6,5,10,78
8,85,Yes,6,9,17,81
1,84,No,4,9,10,57
1,48,Yes,7,0,1,24
7,77,No,7,6,13,66
5,45,Yes,5,6,11,31
5,90,Yes,4,4,9,73
1,92,Yes,4,8,9,66
9,81,No,7,1,10,78
1,94,Yes,8,4,5,66
5,74,Yes,7,1,6,57
9,57,No,7,1,10,50
4,92,No,7,8,12,77
8,58,No,6,6,14,54
6,44,Yes,9,3,9,30
3,64,Yes,4,7,10,43
4,50,Yes,9,3,7,34
2,49,Yes,6,0,2,26
1,56,Yes,8,9,10,36
8,75,Yes,5,2,10,69
1,65,No,8,9,10,39
1,70,Yes,4,0,1,44
4,71,Yes,5,1,5,56
6,60,Yes,9,1,7,47
9,57,No,8,6,15,56
1,99,Yes,4,3,4,73
7,57,No,8,9,16,48
5,40,Yes,5,8,13,24
8,53,No,5,1,9,49
7,47,No,8,8,15,41
4,41,No,6,5,9,24
4,90,Yes,8,9,13,72
6,54,No,9,7,13,45
6,99,Yes,8,6,12,92
9,73,No,8,7,16,68
5,75,Yes,6,8,13,62
8,40,No,7,7,15,36
5,90,No,5,5,10,77
2,60,Yes,9,7,9,40
6,81,No,4,7,13,69
9,40,Yes,5,1,10,38
3,71,No,5,1,4,50
1,59,No,7,0,1,33
1,93,Yes,5,9,10,69
3,86,Yes,5,1,4,63
5,75,Yes,6,6,11,59
3,78,No,6,2,5,54
9,69,Yes,6,3,12,65
8,46,Yes,6,3,11,41
3,61,No,6,3,6,41
9,96,Yes,9,1,10,94
6,89,Yes,4,5,11,80
7,84,No,7,0,7,74
4,49,No,8,4,8,33
4,95,No,9,1,5,78
2,47,No,6,8,10,21
5,66,No,7,1,6,49
8,49,Yes,8,5,13,43
7,53,No,5,3,10,40
7,85,No,9,5,12,77
6,98,No,5,1,7,84
3,91,Yes,7,1,4,74
5,93,Yes,4,6,11,78
1,50,Yes,4,2,3,21
7,45,Yes,7,2,9,34
9,60,No,4,6,15,54
1,72,No,4,7,8,47
2,58,No,5,6,8,36
3,78,Yes,4,2,5,53
3,63,No,4,2,5,45
8,57,Yes,7,6,14,52
7,74,Yes,4,2,9,66
6,91,Yes,9,1,7,79
4,82,No,6,6,10,63
9,76,No,6,2,11,72
1,58,No,7,4,5,33
2,92,No,6,6,8,70
4,63,Yes,5,1,5,47
3,95,No,9,7,10,73
1,73,Yes,9,1,2,50
5,61,Yes,7,3,8,48
7,43,Yes,4,3,10,33
2,96,Yes,6,7,9,72
5,49,Yes,5,0,5,31
6,41,Yes,7,8,14,32
7,47,Yes,7,5,12,34
1,72,No,4,3,4,41
7,98,No,8,5,12,91
4,77,Yes,6,5,9,61
8,82,No,5,8,16,75
4,98,No,7,3,7,80
6,67,No,6,7,13,57
9,49,No,5,0,9,46
5,84,Yes,9,5,10,71
4,40,No,9,4,8,21
8,73,Yes,5,2,10,69
9,42,Yes,9,3,12,37
4,48,No,7,7,11,32
3,44,No,6,9,12,26
8,81,Yes,5,1,9,74
5,49,Yes,7,7,12,34
2,51,No,6,6,8,24
9,57,No,6,0,9,53
3,97,Yes,7,1,4,74
2,60,No,6,6,8,37
1,60,Yes,8,2,3,31
8,40,Yes,5,1,9,29
3,42,Yes,5,0,3,21
7,44,Yes,6,6,13,37
1,64,No,7,2,3,37
1,97,Yes,4,5,6,73
9,88,Yes,9,9,18,87
8,47,No,6,7,15,45
3,56,No,4,5,8,32
6,48,Yes,6,6,12,35
3,71,No,4,5,8,52
4,45,No,6,6,10,27
1,88,Yes,7,4,5,65
5,79,No,9,8,13,64
1,60,No,4,2,3,30
1,46,No,8,5,6,22
7,46,No,7,8,15,35
6,86,No,9,0,6,72
2,78,Yes,6,4,6,55
2,93,No,4,3,5,71
7,66,Yes,9,8,15,60
1,47,Yes,5,0,1,19
2,48,No,7,3,5,25
8,67,No,4,0,8,55
6,54,No,7,2,8,41
2,41,No,4,3,5,17
7,46,No,5,0,7,36
4,86,No,8,4,8,71
2,57,No,5,5,7,35
6,61,No,6,0,6,48
9,89,No,7,9,18,82
9,49,No,8,9,18,48
8,93,No,7,3,11,86
3,89,No,9,3,6,69
3,72,Yes,4,0,3,50
2,46,No,6,1,3,22
5,42,Yes,6,9,14,25
4,53,Yes,7,4,8,33
7,83,No,6,1,8,71
4,85,Yes,7,2,6,70
9,75,No,4,8,17,71
2,52,No,4,4,6,28
6,55,Yes,7,0,6,44
7,55,No,5,4,11,46
4,93,Yes,5,2,6,76
6,44,Yes,4,0,6,29
7,91,No,8,2,9,84
4,64,Yes,5,5,9,47
8,77,Yes,7,9,17,70
9,77,No,4,4,13,73
1,89,Yes,6,0,1,63
7,77,No,6,1,8,68
9,78,No,5,4,13,74
5,95,No,8,8,13,82
2,95,No,9,4,6,77
6,87,Yes,5,4,10,77
7,80,No,8,0,7,71
2,65,Yes,5,4,6,39
2,98,Yes,6,7,9,77
1,52,No,8,8,9,25
4,83,No,6,9,13,63
7,90,No,7,2,9,80
9,65,Yes,7,3,12,62
3,94,No,4,6,9,75
7,94,Yes,6,6,13,88
7,40,No,6,0,7,31
7,47,No,4,5,12,36
2,43,Yes,7,8,10,21
6,60,Yes,7,4,10,50
2,61,No,8,7,9,40
6,90,No,8,9,15,81
3,92,No,9,8,11,75
2,97,Yes,7,9,11,76
6,76,No,9,9,15,66
2,88,No,5,2,4,59
5,42,Yes,6,0,5,26
2,58,No,8,1,3,33
3,40,Yes,5,4,7,19
3,68,Yes,8,9,12,49
6,62,No,4,6,12,50
6,72,No,6,5,11,56
3,94,Yes,9,3,6,74
3,91,Yes,9,8,11,72
1,80,No,8,3,4,53
7,62,Yes,7,2,9,60
8,44,Yes,9,4,12,35
2,46,No,4,3,5,22
4,96,Yes,4,1,5,80
7,97,Yes,7,2,9,88
8,45,Yes,4,6,14,39
1,88,Yes,6,1,2,63
4,61,Yes,8,0,4,44
6,88,Yes,4,1,7,72
3,52,No,6,7,10,33
5,51,No,7,7,12,39
9,43,No,8,9,18,45
3,47,No,7,1,4,23
5,76,Yes,8,5,10,63
8,70,No,4,6,14,63
6,76,Yes,4,0,6,63
4,84,No,8,6,10,64
8,65,Yes,6,7,15,62
3,82,No,6,8,11,64
3,47,Yes,6,7,10,28
4,79,No,5,2,6,60
9,72,No,9,7,16,70
5,84,No,9,2,7,70
8,68,No,9,5,13,60
6,44,No,6,3,9,33
3,67,Yes,4,6,9,46
8,92,No,5,7,15,88
9,79,Yes,6,9,18,78
8,56,No,4,5,13,47
4,94,No,5,9,13,75
6,62,No,4,3,9,51
1,84,Yes,8,7,8,61
4,48,No,4,6,10,29
8,41,No,5,9,17,36
1,71,Yes,6,7,8,44
3,90,Yes,9,9,12,75
1,91,Yes,5,6,7,63
9,88,Yes,6,2,11,85
2,70,No,6,2,4,46
9,46,Yes,7,8,17,44
4,69,Yes,8,6,10,55
2,97,No,7,0,2,76
4,42,Yes,9,2,6,25
6,90,Yes,5,0,6,74
7,90,Yes,7,5,12,79
3,95,No,9,1,4,75
3,48,Yes,6,6,9,28
8,49,Yes,5,7,15,44
5,85,Yes,7,5,10,72
4,89,No,4,4,8,72
7,97,No,9,9,16,94
7,86,Yes,9,3,10,79
9,65,No,8,8,17,64
9,40,Yes,4,7,16,35
5,69,No,5,4,9,54
8,96,No,7,0,8,90
1,77,Yes,6,7,8,52
9,54,Yes,7,7,16,50
8,64,Yes,5,6,14,58
6,45,No,5,6,12,33
3,57,Yes,5,7,10,38
3,40,No,5,0,3,17
8,95,No,9,2,10,90
5,42,Yes,7,3,8,32
7,56,No,4,5,12,46
5,87,No,6,9,14,76
8,47,Yes,6,9,17,45
4,99,No,8,8,12,81
2,88,No,9,3,5,66
3,79,Yes,5,5,8,59
8,56,Yes,5,8,16,54
7,64,Yes,5,8,15,59
2,80,No,9,5,7,55
6,51,No,4,4,10,36
9,68,No,5,2,11,66
4,64,Yes,8,4,8,47
9,90,No,8,2,11,89
2,75,No,4,4,6,50
2,92,No,9,9,11,69
9,93,Yes,5,9,18,94
7,64,Yes,7,0,7,54
7,68,Yes,7,5,12,60
1,50,No,6,6,7,22
6,99,No,4,1,7,84
7,43,Yes,7,2,9,34
6,53,Yes,6,9,15,40
6,85,No,8,8,14,78
2,77,Yes,6,7,9,56
6,56,No,5,3,9,45
4,41,Yes,5,7,11,23
9,47,Yes,8,7,16,45
1,75,Yes,4,5,6,50
8,49,No,9,0,8,37
5,46,Yes,5,1,6,29
1,75,No,5,3,4,44
4,55,Yes,6,3,7,38
1,53,Yes,6,1,2,24
6,55,No,6,8,14,43
2,64,No,7,1,3,39
5,80,Yes,8,5,10,70
7,43,No,4,4,11,37
2,68,Yes,6,3,5,47
6,95,No,4,5,11,85
6,45,No,6,3,9,32
5,40,Yes,5,8,13,24
5,78,Yes,4,9,14,60
3,40,No,7,6,9,20
2,90,No,6,2,4,66
7,79,Yes,9,9,16,74
1,96,No,8,3,4,70
6,42,No,5,0,6,25
6,40,No,6,5,11,25
3,40,No,4,1,4,20
2,78,Yes,6,3,5,59
2,60,Yes,5,4,6,33
9,84,No,8,7,16,81
5,69,No,8,2,7,51
7,71,Yes,8,5,12,64
5,72,No,9,0,5,58
7,87,No,5,8,15,78
4,61,No,9,0,4,43
8,69,No,9,1,9,64
7,93,No,6,0,7,85
5,85,Yes,5,7,12,73
6,43,No,5,3,9,32
5,62,No,6,1,6,46
7,94,No,7,6,13,85
2,83,Yes,9,7,9,64
5,64,No,8,8,13,50
3,51,No,4,4,7,29
9,56,Yes,9,2,11,53
6,92,Yes,4,0,6,83
3,54,Yes,6,7,10,36
7,49,Yes,4,5,12,37
4,74,No,7,4,8,57
3,94,No,5,6,9,75
8,91,No,8,4,12,84
4,91,Yes,4,3,7,74
1,68,No,4,4,5,40
6,51,Yes,6,6,12,37
1,40,Yes,6,5,6,11
5,40,No,5,9,14,28
7,49,Yes,8,9,16,40
6,57,Yes,4,8,14,47
2,86,No,5,9,11,65
4,41,No,8,1,5,22
2,88,Yes,5,6,8,66
1,47,No,4,0,1,19
3,61,No,6,7,10,43
3,61,Yes,6,3,6,41
7,65,Yes,6,7,14,56
1,65,No,7,7,8,42
9,48,No,5,3,12,45
6,60,Yes,4,3,9,46
4,70,No,5,4,8,51
3,91,Yes,6,6,9,74
3,82,Yes,9,5,8,67
2,45,No,9,0,2,21
2,95,No,5,5,7,73
5,53,No,8,2,7,39
9,72,No,9,8,17,69
2,46,No,9,2,4,24
2,63,Yes,5,8,10,36
6,48,No,7,4,10,38
2,50,Yes,7,9,11,29
4,95,No,6,7,11,72
6,62,Yes,4,8,14,48
5,87,No,8,8,13,71
1,90,No,4,6,7,61
6,41,Yes,4,9,15,29
1,54,No,8,0,1,31
3,74,No,7,7,10,56
5,75,Yes,9,6,11,62
5,91,Yes,6,3,8,78
6,93,Yes,5,5,11,83
8,67,No,7,9,17,65
5,78,Yes,6,1,6,65
1,83,Yes,9,3,4,59
5,43,No,7,7,12,26
3,49,No,8,3,6,32
4,45,No,4,9,13,27
8,96,No,8,3,11,89
7,69,No,9,3,10,57
5,93,No,5,9,14,77
2,85,Yes,8,8,10,65
6,74,Yes,9,1,7,63
6,88,No,4,6,12,78
6,82,Yes,7,2,8,74
9,49,Yes,6,3,12,41
8,97,Yes,9,0,8,90
8,92,Yes,9,2,10,88
1,71,No,5,1,2,47
5,81,No,7,9,14,66
7,81,Yes,9,6,13,75
6,42,No,9,5,11,29
5,95,Yes,6,0,5,80
8,65,Yes,4,7,15,59
3,54,No,8,8,11,34
6,56,Yes,7,0,6,47
5,66,No,6,4,9,53
8,57,No,6,6,14,50
4,90,No,8,1,5,72
8,58,No,7,5,13,54
2,51,No,7,7,9,28
9,63,No,4,7,16,59
9,44,No,7,9,18,40
6,63,No,9,9,15,55
4,66,No,8,7,11,49
4,87,Yes,7,5,9,70
6,69,No,4,5,11,57
5,54,Yes,6,2,7,39
6,86,No,9,1,7,75
7,98,Yes,7,4,11,87
7,77,No,8,8,15,70
9,83,No,7,3,12,76
8,73,No,5,4,12,68
6,66,Yes,4,5,11,53
6,59,Yes,6,5,11,48
5,80,No,5,3,8,63
1,71,Yes,8,3,4,47
9,43,No,7,7,16,38
9,44,Yes,4,4,13,43
9,92,Yes,9,4,13,90
8,97,Yes,7,8,16,95
3,47,No,7,3,6,24
1,61,Yes,7,6,7,35
8,81,Yes,9,4,12,75
7,46,No,7,8,15,37
5,61,No,4,7,12,46
7,85,Yes,9,7,14,80
4,69,Yes,9,9,13,55
9,76,No,5,9,18,71
2,55,No,8,2,4,32
9,54,No,9,8,17,51
9,44,No,5,7,16,43
5,42,No,4,2,7,23
1,62,Yes,8,9,10,37
7,49,No,9,0,7,40
4,44,No,6,4,8,24
9,62,Yes,5,3,12,60
6,54,No,4,7,13,44
3,57,No,4,5,8,34
6,64,No,4,9,15,51
6,47,Yes,8,4,10,39
5,70,No,7,8,13,57
2,60,No,6,5,7,36
2,41,No,8,2,4,16
7,61,No,8,5,12,52
2,47,Yes,9,3,5,25
6,62,Yes,5,4,10,51
5,71,No,6,5,10,56
4,47,No,4,8,12,27
7,43,No,8,2,9,33
8,69,No,6,0,8,60
4,58,No,5,1,5,39
1,62,No,7,7,8,41
1,57,No,6,3,4,35
1,92,Yes,4,6,7,67
1,68,No,8,1,2,39
5,62,Yes,7,9,14,51
4,72,Yes,5,7,11,56
9,91,No,4,9,18,93
3,86,Yes,7,8,11,68
7,57,Yes,9,6,13,49
8,93,Yes,9,9,17,88
6,83,No,5,0,6,72
1,72,Yes,4,1,2,44
8,46,Yes,8,8,16,41
3,90,No,5,9,12,69
8,67,No,7,6,14,66
4,40,Yes,4,2,6,20
8,95,No,9,4,12,92
1,78,No,9,0,1,53
3,73,Yes,6,9,12,50
6,78,Yes,4,2,8,70
9,58,Yes,7,3,12,51
2,70,No,7,3,5,45
1,52,Yes,6,6,7,25
3,96,Yes,7,4,7,75
4,63,No,4,8,12,45
5,44,No,9,6,11,29
3,62,No,5,1,4,43
2,58,No,9,7,9,38
2,40,Yes,9,1,3,16
7,72,Yes,4,6,13,61
9,98,Yes,7,4,13,95
2,89,No,6,9,11,65
7,95,Yes,6,5,12,85
7,72,No,8,3,10,66
7,71,No,6,4,11,61
3,98,No,6,4,7,79
7,67,Yes,7,6,13,59
1,76,No,5,3,4,52
1,80,Yes,5,4,5,56
5,51,Yes,7,3,8,37
2,48,Yes,6,3,5,29
9,89,No,4,7,16,84
7,94,Yes,9,4,11,87
4,50,Yes,9,8,12,36
4,72,No,5,4,8,56
2,58,Yes,7,7,9,34
5,93,No,4,2,7,77
4,96,Yes,6,6,10,80
1,81,No,7,0,1,59
8,73,No,5,4,12,68
3,46,No,4,1,4,26
6,70,No,4,7,13,57
4,91,No,5,5,9,72
9,41,Yes,4,4,13,36
7,58,Yes,9,2,9,51
9,77,Yes,5,0,9,76
3,71,Yes,9,9,12,51
1,49,No,7,9,10,28
5,80,No,8,9,14,69
3,47,Yes,6,9,12,30
6,65,No,7,7,13,56
8,69,Yes,9,4,12,64
4,50,No,6,8,12,33
5,80,No,6,6,11,67
5,59,Yes,9,0,5,45
4,99,Yes,9,0,4,84
4,59,No,5,6,10,40
4,48,Yes,8,6,10,33
4,47,Yes,9,8,12,31
4,99,Yes,6,1,5,81
5,54,Yes,6,6,11,38
2,73,No,7,1,3,48
2,63,No,8,9,11,39
9,72,No,8,9,18,71
2,80,No,6,1,3,55
6,80,Yes,8,4,10,70
2,84,Yes,7,8,10,65
5,79,Yes,5,8,13,65
4,66,No,6,9,13,49
7,60,No,4,0,7,49
7,44,No,6,6,13,35
6,74,No,6,9,15,62
5,60,Yes,5,9,14,48
1,43,Yes,9,2,3,18
3,88,Yes,9,9,12,70
9,87,No,4,9,18,83
1,55,No,4,0,1,29
5,96,No,4,1,6,79
2,70,No,9,5,7,49
4,65,No,5,9,13,49
1,91,No,8,1,2,63
3,74,Yes,4,1,4,50
7,45,No,8,3,10,36
3,72,No,7,2,5,53
4,60,No,5,7,11,39
2,55,Yes,8,7,9,32
3,86,Yes,9,5,8,69
9,78,No,9,3,12,74
3,73,Yes,4,6,9,55
5,81,Yes,4,8,13,72
2,96,Yes,8,1,3,72
4,99,No,9,5,9,86
7,54,Yes,8,6,13,47
7,45,Yes,7,0,7,34
3,41,Yes,5,5,8,24
5,63,No,9,7,12,51
1,95,Yes,6,6,7,73
1,88,No,9,1,2,68
5,67,Yes,7,1,6,52
9,40,No,9,3,12,38
1,40,No,7,4,5,11
1,67,No,9,4,5,41
4,75,No,7,1,5,57
4,59,No,4,6,10,41
2,87,Yes,8,7,9,62
9,47,Yes,9,1,10,48
9,40,Yes,5,3,12,37
2,65,No,4,2,4,41
9,90,No,7,3,12,91
6,82,No,5,4,10,73
8,88,Yes,4,5,13,82
4,64,No,6,1,5,44
2,49,No,9,9,11,29
2,51,No,9,5,7,32
9,80,No,7,8,17,78
1,46,Yes,4,7,8,21
7,51,No,4,0,7,43
3,86,No,7,8,11,69
3,79,No,6,9,12,56
2,56,No,9,1,3,31
6,44,Yes,8,0,6,36
2,53,No,6,5,7,30
4,73,Yes,7,0,4,56
9,87,Yes,8,5,14,87
9,56,No,4,1,10,54
6,74,No,6,6,12,61
4,94,Yes,6,6,10,77
7,40,No,9,3,10,30
1,98,No,9,1,2,69
4,89,Yes,8,6,10,74
5,89,Yes,4,0,5,72
8,75,Yes,6,1,9,71
2,54,Yes,8,1,3,30
5,99,Yes,6,0,5,82
6,58,Yes,9,8,14,51
5,90,No,4,5,10,76
9,81,No,4,2,11,76
1,44,No,5,5,6,17
3,58,No,8,6,9,40
2,82,No,9,2,4,63
3,78,No,9,3,6,60
9,44,No,9,9,18,44
9,91,No,7,0,9,87
2,51,No,6,5,7,27
3,58,Yes,4,5,8,30
4,86,Yes,6,8,12,68
9,51,No,6,1,10,44
3,75,No,7,4,7,53
7,51,Yes,4,4,11,40
3,57,Yes,5,6,9,36
7,88,Yes,9,4,11,79
7,90,No,8,9,16,86
9,87,Yes,6,3,12,85
2,82,Yes,7,9,11,61
6,73,Yes,7,1,7,63
9,87,No,8,7,16,82
2,72,Yes,8,4,6,47
2,88,No,4,3,5,66
5,57,Yes,6,8,13,48
8,96,Yes,6,1,9,90
9,68,No,8,2,11,70
2,84,Yes,9,7,9,64
5,44,Yes,5,3,8,27
7,64,Yes,6,8,15,58
6,63,No,7,9,15,48
6,68,No,9,9,15,57
7,98,No,8,9,16,90
3,77,Yes,6,9,12,56
3,72,No,4,8,11,50
9,49,Yes,8,9,18,48
8,76,Yes,7,8,16,74
5,99,Yes,4,0,5,86
6,72,Yes,8,5,11,59
1,62,Yes,8,9,10,43
1,97,Yes,6,5,6,75
4,50,Yes,4,7,11,32
2,63,Yes,8,6,8,44
7,63,No,9,6,13,54
2,46,No,7,1,3,24
2,89,Yes,4,3,5,61
5,60,No,9,0,5,45
4,59,No,6,6,10,44
8,92,No,5,3,11,84
4,49,Yes,8,8,12,32
6,64,No,5,5,11,50
5,86,Yes,8,5,10,73
2,75,No,9,8,10,52
8,87,No,6,7,15,85
2,86,No,6,5,7,61
9,54,Yes,6,5,14,52
9,83,Yes,6,5,14,82
3,79,Yes,4,3,6,57
4,79,Yes,4,4,8,58
8,89,Yes,8,2,10,83
9,45,Yes,4,8,17,41
3,76,Yes,8,1,4,58
5,41,Yes,4,6,11,25
8,51,Yes,4,0,8,43
3,97,No,4,9,12,74
7,43,No,7,6,13,34
8,62,Yes,6,1,9,58
3,52,No,7,4,7,34
2,56,No,4,0,2,30
7,70,Yes,4,4,11,62
9,55,Yes,7,3,12,52
1,80,No,9,0,1,56
3,65,Yes,8,0,3,45
5,67,No,6,6,11,51
3,40,Yes,8,2,5,18
1,86,No,9,9,10,64
7,51,Yes,6,8,15,38
7,76,No,5,8,15,69
8,94,No,6,9,17,89
5,95,No,8,8,13,81
5,89,No,6,0,5,76
5,59,Yes,5,3,8,38
1,41,No,5,0,1,14
5,75,Yes,4,0,5,62
6,54,No,5,8,14,39
1,77,Yes,7,4,5,51
7,61,No,8,0,7,53
1,83,Yes,7,2,3,54
2,89,No,9,6,8,68
2,71,No,7,1,3,53
5,98,Yes,8,3,8,86
7,59,No,9,1,8,51
1,75,No,7,8,9,48
1,72,No,7,8,9,50
1,54,No,9,6,7,24
6,89,Yes,7,6,12,79
2,85,No,5,1,3,63
1,42,Yes,8,9,10,13
6,68,Yes,8,7,13,54
2,86,Yes,8,0,2,61
6,66,Yes,7,7,13,58
8,44,No,5,4,12,35
2,98,No,8,3,5,78
9,95,Yes,6,9,18,95
8,70,No,8,1,9,61
1,61,No,4,2,3,32
7,74,Yes,6,9,16,66
6,93,Yes,8,1,7,83
6,46,Yes,7,3,9,35
6,45,No,8,2,8,33
6,65,Yes,5,4,10,55
7,93,Yes,5,6,13,87
3,40,No,8,8,11,18
6,58,No,7,4,10,45
3,46,No,7,7,10,26
7,75,No,7,1,8,66
7,51,No,8,5,12,44
8,59,No,8,7,15,55
2,62,No,4,8,10,40
9,64,No,5,3,12,61
5,69,Yes,6,3,8,54
9,98,No,6,6,15,95
5,68,Yes,5,3,8,56
7,70,No,9,4,11,61
9,57,No,4,1,10,53
4,80,Yes,5,1,5,60
2,58,No,4,9,11,35
9,93,Yes,9,4,13,93
2,43,No,4,9,11,20
3,40,Yes,7,9,12,24
2,80,Yes,5,1,3,54
3,98,No,6,5,8,78
6,54,Yes,8,5,11,45
3,93,Yes,9,7,10,77
8,47,No,9,0,8,40
6,54,No,8,6,12,44
7,54,Yes,5,6,13,45
1,89,No,8,8,9,66
3,78,Yes,4,3,6,57
3,61,Yes,8,6,9,42
2,57,Yes,4,5,7,34
7,55,No,4,3,10,43
9,41,No,6,9,18,37
4,75,Yes,8,7,11,57
5,59,Yes,6,2,7,44
3,55,Yes,8,7,10,35
9,42,No,4,4,13,36
4,95,Yes,8,3,7,82
5,69,No,9,2,7,55
1,94,Yes,9,9,10,74
2,41,Yes,6,6,8,19
9,74,Yes,7,6,15,72
2,65,Yes,9,5,7,42
5,96,No,6,2,7,81
8,44,No,7,8,16,38
3,41,No,5,1,4,21
6,90,No,6,2,8,82
4,95,No,9,0,4,80
7,59,Yes,9,6,13,51
3,73,No,8,1,4,53
6,73,No,7,9,15,62
9,93,No,9,7,16,91
1,95,No,8,8,9,71
3,94,Yes,7,1,4,74
2,59,Yes,6,5,7,40
8,89,Yes,6,0,8,83
7,64,No,8,7,14,58
2,59,Yes,6,4,6,38
6,64,Yes,8,8,14,56
3,92,No,4,2,5,73
8,53,No,7,1,9,46
3,99,No,8,6,9,82
9,86,Yes,7,6,15,88
1,83,No,4,9,10,56
5,82,Yes,7,4,9,68
3,82,Yes,8,6,9,63
6,78,Yes,6,5,11,71
2,51,Yes,7,8,10,27
9,87,Yes,7,2,11,85
6,44,No,9,3,9,34
7,41,Yes,9,8,15,33
5,93,Yes,4,9,14,77
9,55,Yes,5,7,16,50
1,94,Yes,6,9,10,69
5,69,Yes,8,5,10,55
6,86,No,4,2,8,76
7,82,Yes,8,8,15,74
4,77,Yes,8,8,12,61
1,84,Yes,7,5,6,60
8,90,Yes,4,1,9,84
4,81,No,4,6,10,56
3,63,Yes,9,8,11,43
7,90,Yes,6,8,15,82
2,69,Yes,5,2,4,43
8,76,Yes,8,1,9,73
6,96,No,6,4,10,81
7,98,No,9,9,16,94
5,92,No,6,6,11,74
9,78,Yes,8,2,11,76
5,50,No,7,3,8,38
5,53,No,7,9,14,38
3,62,No,8,1,4,42
1,92,No,9,9,10,71
2,55,No,9,1,3,34
8,89,Yes,4,6,14,84
1,60,No,5,1,2,32
7,94,No,7,0,7,85
5,94,No,5,3,8,76
3,43,Yes,6,5,8,21
7,72,Yes,6,9,16,65
9,93,No,8,9,18,92
2,86,Yes,8,3,5,69
8,53,Yes,8,0,8,49
9,58,No,9,0,9,54
3,98,Yes,7,8,11,81
2,44,No,5,0,2,15
7,75,No,6,6,13,66
5,70,No,5,6,11,56
5,84,Yes,7,0,5,71
5,57,No,5,0,5,40
4,83,No,5,5,9,66
5,70,Yes,9,7,12,57
4,94,No,8,6,10,79
6,69,Yes,9,5,11,57
4,60,Yes,9,9,13,43
2,86,No,5,2,4,65
9,69,Yes,5,6,15,66
2,94,No,9,5,7,74
9,80,Yes,5,7,16,76
6,43,Yes,9,3,9,30
9,44,Yes,4,8,17,39
9,80,Yes,9,0,9,79
3,84,No,6,6,9,60
1,49,No,6,8,9,24
1,66,Yes,5,9,10,42
3,55,No,9,0,3,33
5,69,No,9,9,14,57
3,52,No,8,2,5,32
9,75,No,8,6,15,71
9,60,No,8,8,17,58
3,84,No,9,0,3,64
3,92,No,9,5,8,72
5,79,Yes,6,1,6,64
2,84,No,7,4,6,61
6,54,Yes,5,6,12,43
7,59,Yes,6,6,13,54
9,59,Yes,8,9,18,56
6,84,No,6,6,12,75
3,94,No,6,3,6,72
5,98,Yes,6,5,10,84
4,44,Yes,8,9,13,30
5,93,No,7,5,10,80
8,93,No,4,6,14,82
8,99,No,5,8,16,96
6,71,Yes,5,5,11,60
1,45,Yes,6,9,10,19
8,69,No,7,0,8,62
8,65,No,8,7,15,61
2,76,Yes,4,1,3,53
4,52,No,4,2,6,34
2,68,No,6,4,6,43
4,44,Yes,6,5,9,27
7,64,Yes,8,6,13,55
9,52,Yes,8,3,12,51
8,63,Yes,9,2,10,58
9,70,No,8,8,17,69
8,59,Yes,6,3,11,52
2,94,No,7,8,10,72
7,47,No,6,8,15,38
2,99,No,6,2,4,73
2,48,Yes,4,2,4,26
4,60,Yes,8,7,11,46
1,90,No,5,0,1,60
5,59,No,8,5,10,43
6,54,Yes,9,5,11,43
9,65,No,7,8,17,65
8,93,No,7,1,9,89
2,81,No,8,7,9,60
1,50,No,8,6,7,22
2,76,No,6,1,3,53
7,80,No,5,0,7,70
4,50,No,6,3,7,31
5,66,No,4,1,6,52
7,69,Yes,4,2,9,59
3,58,Yes,7,1,4,40
2,73,No,7,8,10,50
7,77,No,5,3,10,66
5,62,Yes,7,0,5,45
1,92,Yes,9,7,8,69
1,40,Yes,4,3,4,13
9,42,No,5,9,18,37
5,42,Yes,4,7,12,25
1,67,Yes,8,7,8,45
7,53,No,8,8,15,47
9,91,Yes,5,9,18,93
1,69,No,6,6,7,40
4,97,Yes,9,3,7,85
3,93,Yes,9,1,4,73
5,44,Yes,7,5,10,27
7,88,Yes,5,3,10,80
8,54,Yes,9,5,13,46
2,77,No,7,7,9,57
7,53,No,4,2,9,43
1,53,Yes,6,0,1,25
7,96,No,7,4,11,90
8,98,Yes,8,2,10,93
2,88,Yes,8,5,7,67
9,47,Yes,4,2,11,44
1,47,Yes,5,0,1,18
6,58,Yes,7,8,14,46
1,71,No,4,4,5,44
3,70,No,8,1,4,47
6,68,No,8,1,7,55
3,80,No,8,8,11,59
8,50,Yes,6,0,8,42
5,84,No,6,9,14,69
2,52,Yes,8,2,4,29
4,66,Yes,9,9,13,53
9,95,No,5,6,15,90
4,58,No,6,0,4,40
8,65,Yes,7,1,9,55
5,92,Yes,6,5,10,78
1,90,Yes,7,8,9,64
7,76,No,6,8,15,68
3,87,Yes,8,7,10,68
8,48,Yes,7,2,10,44
3,67,Yes,5,1,4,45
1,71,Yes,6,0,1,47
5,91,No,6,8,13,73
2,93,No,8,4,6,71
4,42,Yes,7,2,6,25
1,90,No,9,9,10,65
9,71,Yes,8,9,18,70
6,44,No,7,4,10,33
8,47,No,6,2,10,42
4,53,No,6,8,12,35
9,95,No,6,0,9,90
2,42,Yes,6,0,2,17
9,63,Yes,4,2,11,59
5,52,Yes,6,5,10,36
6,82,No,6,1,7,71
3,68,No,9,0,3,45
4,47,Yes,9,7,11,31
6,90,No,7,9,15,77
7,81,No,6,8,15,73
1,70,Yes,6,9,10,47
7,65,No,7,0,7,56
1,57,Yes,6,2,3,30
5,97,No,6,4,9,84
6,57,Yes,8,6,12,41
2,96,No,4,9,11,73
9,46,No,7,3,12,41
6,87,No,8,5,11,77
7,77,No,9,0,7,63
8,87,No,5,3,11,79
1,55,Yes,5,7,8,28
8,94,No,9,4,12,91
4,95,Yes,4,7,11,76
8,99,Yes,5,0,8,92
6,72,Yes,4,9,15,61
9,95,No,5,8,17,92
4,90,Yes,5,3,7,72
2,42,No,8,8,10,20
2,77,No,5,7,9,54
5,43,No,9,7,12,35
9,75,Yes,4,1,10,67
3,43,No,6,2,5,20
8,81,No,6,9,17,76
4,48,No,6,8,12,33
6,79,Yes,4,2,8,68
6,90,Yes,4,7,13,81
3,56,Yes,6,4,7,36
5,56,Yes,9,6,11,46
3,72,No,5,3,6,50
1,59,Yes,6,7,8,36
7,53,No,7,3,10,44
4,61,Yes,4,4,8,43
7,91,No,7,0,7,79
3,66,Yes,7,9,12,44
5,82,Yes,4,7,12,67
5,42,Yes,6,6,11,27
2,63,No,9,4,6,39
2,69,No,8,5,7,49
4,47,Yes,7,0,4,28
4,61,Yes,6,7,11,46
4,64,Yes,8,8,12,48
6,99,Yes,7,4,10,90
2,49,Yes,6,9,11,24
6,88,Yes,7,6,12,75
7,68,No,6,9,16,61
3,79,No,9,3,6,62
8,93,No,5,5,13,87
2,40,No,5,1,3,13
8,91,No,4,3,11,85
5,60,No,8,4,9,47
2,78,Yes,7,8,10,54
7,63,Yes,7,8,15,57
2,48,Yes,6,7,9,26
6,99,Yes,8,3,9,89
3,83,Yes,7,5,8,61
9,93,No,8,6,15,93
3,65,No,8,0,3,43
3,48,No,5,0,3,24
5,59,No,7,3,8,45
7,95,No,7,2,9,86
8,74,Yes,4,9,17,65
7,75,No,8,3,10,70
9,81,No,6,8,17,79
5,75,No,5,1,6,59
3,93,Yes,4,3,6,72
6,48,Yes,5,6,12,36
5,61,Yes,6,1,6,46
4,40,Yes,4,7,11,24
2,44,Yes,5,9,11,25
7,48,Yes,6,3,10,38
5,76,No,9,8,13,65
4,77,No,4,0,4,59
8,58,No,6,6,14,53
9,47,Yes,4,0,9,45
9,81,Yes,7,9,18,82
3,82,Yes,7,8,11,64
3,71,Yes,5,9,12,50
5,52,No,8,9,14,39
5,59,Yes,9,0,5,43
2,75,Yes,8,2,4,54
1,82,Yes,6,6,7,58
8,83,Yes,4,0,8,73
3,76,Yes,7,4,7,56
1,69,No,8,5,6,42
1,49,Yes,7,2,3,25
2,70,Yes,9,5,7,48
6,64,No,6,3,9,49
6,68,Yes,9,5,11,59
3,63,Yes,9,5,8,45
4,78,No,6,3,7,60
2,60,No,4,0,2,32
2,80,No,9,2,4,59
7,48,No,8,9,16,40
1,81,No,6,6,7,55
7,81,No,6,1,8,69
1,41,No,7,3,4,12
6,43,No,5,5,11,39
3,47,No,9,4,7,25
8,71,No,8,5,13,62
6,53,Yes,4,4,10,40
2,88,No,9,8,10,67
8,52,No,4,1,9,42
5,60,No,7,3,8,44
8,63,No,9,0,8,57
8,89,No,4,6,14,83
6,57,Yes,9,0,6,43
2,84,Yes,6,5,7,61
8,79,Yes,9,9,17,76
6,65,No,8,9,15,54
6,71,No,9,8,14,60
8,83,Yes,4,1,9,74
1,96,No,8,0,1,74
2,94,No,4,9,11,66
9,95,Yes,5,2,11,94
8,92,No,5,5,13,83
7,72,No,8,6,13,65
7,91,No,5,7,14,82
5,70,No,5,3,8,52
2,57,No,6,7,9,34
6,74,No,4,6,12,61
3,51,No,5,7,10,30
4,90,Yes,8,4,8,77
2,64,Yes,6,9,11,45
2,84,No,5,6,8,59
8,70,No,9,3,11,66
8,49,Yes,8,0,8,45
6,86,Yes,4,2,8,73
5,91,Yes,9,9,14,81
8,73,Yes,5,8,16,72
4,90,Yes,8,3,7,72
4,42,Yes,9,4,8,27
5,85,Yes,8,2,7,70
1,78,No,7,5,6,51
1,47,Yes,9,3,4,21
2,71,Yes,8,4,6,50
8,82,Yes,9,6,14,82
7,68,No,7,6,13,58
9,61,No,4,8,17,59
5,59,No,4,1,6,41
2,45,Yes,6,3,5,21
7,82,Yes,9,7,14,78
8,88,Yes,7,3,11,85
7,68,No,8,2,9,59
7,81,No,6,9,16,72
5,95,No,9,5,10,83
2,56,No,6,2,4,31
6,70,No,9,1,7,58
4,92,No,4,8,12,74
2,73,Yes,8,2,4,50
9,77,No,7,0,9,72
7,96,No,4,8,15,84
6,76,No,6,4,10,67
5,43,No,5,6,11,29
3,41,Yes,6,1,4,20
4,51,Yes,5,0,4,31
3,74,No,9,5,8,58
8,45,Yes,4,4,12,39
3,95,Yes,9,9,12,77
7,85,Yes,7,5,12,78
7,47,Yes,8,1,8,39
7,60,Yes,5,6,13,51
7,92,Yes,8,0,7,86
2,97,Yes,9,7,9,78
3,85,No,4,6,9,66
9,74,Yes,4,6,15,74
3,87,No,9,5,8,70
2,54,Yes,9,9,11,38
9,46,Yes,4,4,13,44
9,54,Yes,7,8,17,52
4,84,No,5,2,6,63
9,45,Yes,8,8,17,46
3,86,No,6,4,7,63
7,56,Yes,9,7,14,50
7,43,Yes,9,2,9,37
8,61,No,4,6,14,52
4,71,Yes,8,9,13,55
3,98,Yes,8,3,6,77
3,61,Yes,7,4,7,46
5,66,No,5,3,8,52
1,85,Yes,7,8,9,59
3,54,Yes,7,6,9,32
6,99,Yes,8,5,11,87
3,83,No,5,5,8,61
5,90,Yes,5,9,14,75
9,61,No,5,6,15,59
2,67,Yes,4,4,6,40
2,81,Yes,5,9,11,61
6,77,No,8,2,8,62
6,99,No,4,2,8,86
8,96,No,6,6,14,89
2,48,No,9,9,11,29
9,73,No,7,0,9,72
2,75,Yes,5,3,5,53
1,48,Yes,6,9,10,24
2,54,No,5,7,9,30
7,84,Yes,7,3,10,79
8,59,Yes,8,0,8,51
5,47,No,8,4,9,34
6,97,No,7,0,6,87
1,67,No,6,8,9,43
6,90,Yes,4,7,13,80
8,58,No,9,6,14,54
3,96,Yes,9,4,7,80
1,55,No,9,3,4,29
4,50,No,4,6,10,34
1,81,No,5,2,3,58
8,47,No,7,7,15,38
5,72,Yes,7,4,9,57
1,49,Yes,4,4,5,20
8,57,Yes,6,0,8,49
9,74,No,9,9,18,73
2,82,Yes,7,7,9,61
9,89,Yes,8,6,15,87
8,42,Yes,8,0,8,37
7,79,No,7,3,10,69
3,66,Yes,9,3,6,46
2,98,No,9,8,10,79
7,67,No,9,9,16,60
5,85,Yes,6,1,6,68
6,45,Yes,8,3,9,38
4,86,No,6,9,13,71
2,53,No,4,2,4,28
9,46,No,5,9,18,44
3,49,Yes,9,4,7,31
7,54,No,4,6,13,41
8,70,No,5,4,12,63
2,68,No,8,4,6,44
6,81,Yes,5,3,9,69
8,93,No,5,8,16,88
7,56,No,7,5,12,49
3,98,No,5,9,12,76
1,90,No,7,5,6,63
6,68,No,5,5,11,55
8,88,Yes,7,5,13,86
6,83,Yes,8,0,6,71
5,54,No,8,5,10,41
8,65,No,5,3,11,58
2,51,No,6,1,3,26
1,64,No,8,5,6,39
1,80,No,4,0,1,54
4,44,No,4,0,4,25
6,43,Yes,7,4,10,29
9,83,No,6,5,14,81
1,87,No,9,1,2,65
1,80,Yes,7,9,10,57
5,96,Yes,5,7,12,85
5,70,Yes,8,3,8,60
5,42,Yes,6,3,8,27
6,92,No,7,9,15,82
8,42,Yes,7,4,12,37
3,65,Yes,4,9,12,48
9,89,Yes,5,3,12,85
1,56,No,7,4,5,28
4,99,No,4,9,13,83
9,49,No,6,2,11,47
8,41,Yes,7,7,15,37
9,63,No,9,5,14,62
1,50,Yes,9,7,8,26
9,63,Yes,4,4,13,59
3,74,Yes,9,6,9,59
9,62,Yes,5,9,18,56
1,71,No,8,6,7,46
1,62,No,9,5,6,35
9,73,No,6,9,18,71
6,80,No,7,3,9,69
4,58,Yes,4,5,9,41
7,41,Yes,7,8,15,34
5,99,Yes,8,3,8,89
7,90,Yes,7,5,12,83
8,41,Yes,7,5,13,33
8,54,No,4,2,10,48
1,95,No,8,3,4,71
8,60,Yes,6,2,10,52
6,74,Yes,4,2,8,63
4,44,No,8,9,13,27
8,82,No,8,3,11,79
3,66,Yes,7,3,6,44
4,63,No,5,5,9,45
6,46,No,5,3,9,34
7,45,Yes,6,5,12,34
4,85,Yes,7,1,5,69
4,72,No,5,3,7,56
7,97,No,4,1,8,86
6,88,Yes,6,7,13,78
8,56,No,7,8,16,49
1,85,No,9,6,7,67
7,81,No,4,5,12,71
7,69,Yes,5,7,14,61
7,47,No,5,3,10,36
7,79,No,5,9,16,69
8,85,Yes,5,1,9,80
9,46,Yes,8,3,12,39
9,45,No,9,4,13,39
2,43,Yes,6,8,10,21
7,40,Yes,6,4,11,30
7,54,No,5,8,15,47
4,70,Yes,6,8,12,53
9,64,No,9,7,16,59
8,86,No,4,4,12,79
1,72,Yes,4,1,2,44
2,91,No,6,4,6,66
2,74,No,5,0,2,51
8,94,No,7,7,15,90
1,44,No,9,1,2,16
4,44,No,5,6,10,23
5,75,Yes,8,1,6,62
9,56,Yes,7,4,13,51
7,92,No,9,9,16,84
8,91,No,8,6,14,86
9,53,Yes,6,5,14,50
7,97,No,8,4,11,90
5,68,No,6,5,10,55
5,47,No,8,1,6,31
6,73,Yes,7,9,15,64
5,79,No,8,0,5,64
9,40,Yes,5,0,9,38
3,68,No,6,7,10,46
3,75,No,4,2,5,54
7,90,Yes,8,2,9,81
7,76,Yes,6,8,15,67
6,68,No,4,5,11,54
3,44,No,6,3,6,19
7,92,No,6,3,10,85
5,71,Yes,4,6,11,54
7,99,No,4,5,12,89
2,91,Yes,7,1,3,66
6,63,No,9,8,14,55
8,58,No,8,1,9,52
1,51,No,8,7,8,27
4,91,No,6,3,7,74
1,40,No,5,9,10,14
1,46,No,5,0,1,19
8,56,No,9,0,8,52
7,73,Yes,6,8,15,63
1,82,No,7,3,4,55
2,46,No,4,0,2,18
4,56,No,6,2,6,39
1,98,No,8,2,3,74
3,42,Yes,5,6,9,23
8,68,Yes,5,5,13,57
8,61,No,5,7,15,54
8,77,No,7,6,14,67
6,93,Yes,8,0,6,86
6,82,Yes,7,2,8,71
5,68,Yes,4,8,13,52
9,89,No,6,3,12,85
4,89,Yes,6,2,6,72
7,93,Yes,5,4,11,88
1,81,No,5,7,8,55
9,44,No,4,0,9,39
7,69,No,7,1,8,58
9,62,Yes,9,6,15,65
7,94,Yes,9,0,7,90
2,60,Yes,9,4,6,35
6,95,Yes,8,9,15,88
4,65,No,4,7,11,48
3,93,Yes,6,5,8,72
2,86,No,6,2,4,60
6,60,Yes,7,6,12,45
8,59,Yes,4,2,10,53
6,62,Yes,8,4,10,49
9,43,No,4,6,15,39
5,60,Yes,4,1,6,42
2,60,No,7,9,11,35
8,40,No,8,3,11,34
9,54,No,9,1,10,54
4,56,No,6,6,10,37
6,90,Yes,5,2,8,78
8,53,Yes,9,8,16,49
9,98,No,8,5,14,96
5,58,No,6,0,5,43
6,89,Yes,9,9,15,80
4,99,Yes,7,7,11,80
5,73,No,8,6,11,62
7,45,Yes,8,0,7,37
9,84,Yes,6,2,11,81
6,88,Yes,6,2,8,74
6,45,No,4,2,8,30
8,92,No,4,6,14,87
4,93,No,8,5,9,74
3,44,No,5,1,4,20
7,46,No,7,4,11,37
5,72,Yes,6,5,10,55
2,52,Yes,4,1,3,25
2,90,Yes,7,0,2,67
6,93,No,9,3,9,78
8,40,Yes,9,3,11,35
1,52,No,8,3,4,24
6,82,No,6,0,6,72
2,66,No,9,2,4,42
2,46,No,6,6,8,24
7,91,No,4,3,10,82
1,42,No,9,1,2,15
6,97,Yes,5,7,13,87
7,64,No,9,0,7,59
8,72,Yes,6,8,16,67
7,79,No,5,4,11,69
6,56,Yes,7,1,7,45
9,84,No,9,3,12,83
3,53,No,6,2,5,31
6,76,Yes,9,6,12,61
4,97,No,9,5,9,80
2,95,No,6,8,10,70
1,93,Yes,5,3,4,67
1,62,Yes,4,2,3,37
3,98,No,9,6,9,81
4,63,Yes,8,5,9,46
2,68,Yes,7,4,6,46
1,77,No,6,9,10,52
4,98,Yes,9,6,10,84
7,93,No,4,4,11,84
6,66,Yes,6,8,14,58
6,77,No,9,3,9,66
9,92,No,7,0,9,85
2,79,No,8,9,11,55
4,84,Yes,6,4,8,67
5,89,No,9,0,5,75
1,62,Yes,5,0,1,36
8,70,No,4,0,8,64
8,75,No,8,0,8,69
6,56,No,6,7,13,42
5,76,Yes,9,1,6,64
8,42,No,8,8,16,38
3,75,No,5,6,9,56
3,94,Yes,6,2,5,73
2,44,No,8,8,10,28
5,85,No,6,3,8,67
3,54,Yes,6,6,9,34
3,91,Yes,8,2,5,73
6,88,Yes,6,4,10,79
8,45,No,5,3,11,38
2,98,Yes,8,5,7,78
4,49,No,9,8,12,35
7,93,No,8,4,11,85
1,71,Yes,5,0,1,45
1,62,Yes,5,4,5,37
7,87,No,5,4,11,78
7,56,Yes,9,8,15,52
1,85,Yes,9,7,8,64
1,59,No,6,4,5,32
4,83,Yes,6,4,8,65
5,80,Yes,7,1,6,67
5,54,Yes,6,8,13,40
4,83,No,5,3,7,64
8,85,Yes,7,6,14,79
7,97,Yes,5,9,16,91
9,61,No,4,5,14,56
7,89,No,9,4,11,85
1,91,No,8,4,5,64
7,45,No,4,6,13,34
1,43,Yes,9,1,2,16
7,97,No,9,8,15,88
8,62,No,5,1,9,53
9,83,Yes,6,8,17,80
3,84,No,8,3,6,64
4,58,No,6,9,13,37
4,93,Yes,6,9,13,75
9,84,No,8,5,14,82
7,70,No,8,0,7,60
3,83,Yes,4,4,7,64
5,91,Yes,5,5,10,76
7,42,Yes,6,8,15,35
8,67,Yes,5,8,16,61
1,42,Yes,5,8,9,18
2,53,Yes,7,2,4,25
7,57,Yes,4,3,10,47
2,66,Yes,6,7,9,47
7,90,Yes,9,7,14,81
9,99,Yes,8,1,10,99
2,49,Yes,8,7,9,28
7,88,Yes,5,6,13,77
4,54,No,4,8,12,37
2,58,Yes,4,4,6,35
7,48,Yes,6,1,8,38
5,43,Yes,6,4,9,31
1,54,Yes,5,1,2,29
5,90,Yes,5,4,9,77
3,87,No,5,8,11,70
7,47,No,7,6,13,37
6,88,No,4,6,12,75
8,92,No,5,0,8,83
5,40,Yes,4,8,13,24
2,46,No,9,5,7,23
9,92,No,8,6,15,90
8,70,Yes,8,1,9,64
6,57,No,4,0,6,41
7,51,No,9,3,10,44
9,87,Yes,8,8,17,84
7,69,Yes,8,8,15,65
3,72,No,8,2,5,54
6,98,Yes,6,0,6,84
7,86,No,9,1,8,78
2,46,Yes,6,8,10,21
3,67,No,4,8,11,49
4,88,No,4,0,4,69
6,42,No,7,8,14,31
1,82,Yes,6,0,1,56
9,45,Yes,4,9,18,41
5,70,No,6,3,8,54
7,77,Yes,7,4,11,69
9,54,Yes,4,7,16,53
9,46,No,4,4,13,40
1,82,Yes,4,4,5,58
1,69,Yes,4,3,4,41
3,66,No,5,8,11,46
6,56,No,9,7,13,50
2,94,Yes,9,8,10,75
1,57,Yes,6,6,7,32
1,61,Yes,6,6,7,37
5,95,No,6,4,9,83
4,92,Yes,7,9,13,75
1,65,Yes,5,0,1,39
4,90,Yes,6,5,9,74
3,66,Yes,6,9,12,43
2,79,Yes,4,5,7,56
9,63,Yes,4,9,18,58
1,91,No,4,3,4,64
7,47,No,6,1,8,39
4,60,No,4,0,4,38
5,68,Yes,6,2,7,53
5,82,Yes,7,8,13,68
1,60,No,7,0,1,36
6,42,No,8,4,10,29
9,70,No,5,9,18,67
2,94,No,4,5,7,72
7,66,No,9,8,15,61
6,85,Yes,4,0,6,70
5,66,Yes,5,4,9,51
4,48,Yes,5,0,4,32
4,96,Yes,8,1,5,80
6,72,Yes,5,1,7,62
4,72,No,6,4,8,59
5,65,No,4,9,14,50
6,67,Yes,5,3,9,57
5,83,No,6,5,10,70
7,82,Yes,5,4,11,70
9,70,Yes,9,1,10,69
7,92,No,6,8,15,87
7,40,Yes,7,9,16,29
4,59,Yes,6,7,11,42
1,51,Yes,8,8,9,27
8,56,No,6,5,13,49
4,54,No,5,4,8,35
1,73,Yes,7,4,5,46
5,89,Yes,7,1,6,76
8,55,No,6,3,11,47
4,43,No,5,1,5,22
8,47,No,7,1,9,36
8,73,No,9,7,15,66
3,85,Yes,6,3,6,68
9,64,Yes,6,3,12,61
3,54,Yes,6,6,9,36
1,67,No,7,3,4,39
2,48,No,4,8,10,20
6,41,Yes,5,8,14,28
2,56,No,8,2,4,29
6,97,Yes,8,5,11,86
1,49,No,5,6,7,25
1,48,Yes,4,2,3,20
5,70,Yes,5,3,8,58
9,41,Yes,6,0,9,38
8,63,Yes,9,8,16,62
3,58,No,5,6,9,37
3,56,Yes,5,9,12,34
1,82,Yes,9,6,7,56
3,88,Yes,7,8,11,72
1,49,Yes,8,5,6,25
8,89,No,8,7,15,82
1,94,Yes,6,4,5,70
5,67,Yes,9,7,12,52
9,77,No,6,9,18,76
7,87,Yes,7,0,7,78
4,67,Yes,6,2,6,51
9,98,Yes,9,3,12,96
9,89,Yes,9,8,17,90
2,91,No,4,7,9,64
6,89,No,7,7,13,79
4,40,No,9,1,5,22
8,99,No,9,6,14,96
7,42,No,7,2,9,32
7,54,No,5,5,12,42
9,91,Yes,5,3,12,88
5,49,Yes,4,5,10,36
6,60,Yes,9,3,9,48
1,76,Yes,7,2,3,51
6,54,No,7,1,7,40
2,62,Yes,5,3,5,34
6,53,Yes,8,9,15,43
9,54,No,8,1,10,59
8,49,Yes,9,6,14,42
9,95,Yes,5,0,9,93
8,48,No,9,0,8,37
3,83,Yes,6,4,7,63
8,78,Yes,7,6,14,70
6,44,No,9,0,6,33
6,64,Yes,4,3,9,50
6,95,Yes,8,4,10,84
3,81,Yes,9,1,4,60
1,96,Yes,6,6,7,67
4,65,Yes,7,3,7,47
6,47,No,6,7,13,34
2,61,Yes,9,0,2,38
7,91,Yes,7,9,16,84
7,64,Yes,7,0,7,53
4,87,No,5,0,4,69
4,51,No,5,3,7,32
1,48,No,4,0,1,21
2,49,Yes,4,4,6,30
9,87,Yes,6,5,14,85
8,49,Yes,5,6,14,45
8,48,Yes,7,7,15,43
9,65,Yes,5,7,16,63
7,74,No,7,1,8,64
9,66,Yes,5,3,12,62
2,99,Yes,7,6,8,76
6,70,No,6,8,14,62
3,58,No,5,8,11,40
6,82,No,8,2,8,71
3,77,No,8,6,9,56
8,45,No,7,3,11,38
4,54,Yes,6,8,12,39
6,68,Yes,7,6,12,62
9,86,Yes,6,5,14,84
2,84,Yes,4,8,10,64
2,93,Yes,5,6,8,71
7,44,No,6,7,14,38
2,53,Yes,7,4,6,26
2,92,Yes,4,3,5,67
4,41,No,7,0,4,23
9,62,No,8,7,16,57
8,83,Yes,8,5,13,80
2,91,Yes,5,3,5,68
8,85,No,9,2,10,77
4,58,Yes,5,4,8,37
2,63,No,4,3,5,39
7,59,Yes,8,6,13,49
6,86,No,6,5,11,74
5,66,No,8,2,7,53
1,91,No,9,9,10,67
2,63,Yes,5,0,2,38
8,56,No,7,6,14,47
1,64,No,4,4,5,40
3,85,Yes,9,0,3,68
2,94,Yes,8,0,2,70
5,70,Yes,6,5,10,54
4,67,No,9,3,7,49
7,89,No,6,7,14,79
5,98,No,6,1,6,82
8,67,Yes,4,3,11,62
4,61,Yes,6,7,11,46
6,95,No,6,7,13,86
4,98,Yes,8,4,8,80
2,44,Yes,4,2,4,17
1,93,No,7,3,4,69
1,83,No,7,2,3,58
8,81,Yes,6,1,9,74
4,47,No,9,3,7,32
5,77,Yes,5,8,13,64
8,67,Yes,4,5,13,57
7,96,No,5,3,10,82
8,86,No,4,0,8,78
8,51,Yes,4,6,14,40
6,96,Yes,8,1,7,88
2,64,No,6,5,7,42
6,77,Yes,8,9,15,67
1,83,Yes,9,0,1,56
1,54,Yes,5,6,7,26
3,83,Yes,5,3,6,56
3,80,Yes,7,2,5,63
5,90,No,9,9,14,78
1,92,Yes,9,6,7,68
6,73,Yes,8,2,8,66
7,99,No,8,7,14,90
3,84,No,9,3,6,65
4,52,No,8,2,6,33
3,47,Yes,7,6,9,32
1,98,Yes,8,6,7,74
8,52,No,8,8,16,48
2,75,No,9,9,11,57
1,45,No,9,6,7,22
8,77,No,8,5,13,69
7,71,No,8,2,9,62
7,60,Yes,9,3,10,52
4,83,No,5,7,11,66
9,83,Yes,6,5,14,81
6,88,Yes,5,8,14,75
2,98,No,8,7,9,80
1,46,No,4,7,8,20
1,65,No,4,9,10,40
9,54,No,7,9,18,55
4,95,No,5,6,10,78
5,88,Yes,9,9,14,76
3,81,No,7,0,3,60
4,62,No,7,4,8,44
8,91,Yes,4,6,14,85
4,77,No,5,9,13,56
9,80,No,6,8,17,76
9,54,No,9,3,12,49
6,87,Yes,5,7,13,72
2,92,No,7,0,2,69
7,79,No,8,3,10,72
9,55,No,7,3,12,50
6,71,No,5,1,7,57
3,76,Yes,4,2,5,56
7,57,No,5,2,9,46
5,59,Yes,6,8,13,45
1,85,No,9,6,7,60
3,41,No,9,1,4,22
5,94,No,8,8,13,81
7,62,Yes,8,7,14,54
3,69,No,7,5,8,48
6,42,No,5,5,11,28
5,85,Yes,9,1,6,73
1,78,No,4,2,3,52
6,86,No,6,5,11,74
8,88,No,7,2,10,84
1,40,No,5,6,7,13
2,80,Yes,4,4,6,57
4,61,Yes,5,3,7,42
2,68,Yes,4,7,9,47
9,53,No,5,1,10,48
8,87,No,5,2,10,81
8,67,No,9,9,17,63
4,60,No,7,3,7,43
5,84,Yes,5,9,14,71
4,71,No,5,5,9,49
9,45,Yes,7,4,13,43
2,93,No,7,4,6,69
8,40,No,8,6,14,34
2,60,Yes,8,7,9,37
1,96,No,9,5,6,74
3,43,Yes,7,2,5,21
9,42,Yes,6,3,12,38
3,88,No,9,0,3,67
9,69,Yes,4,4,13,64
7,70,Yes,7,9,16,61
1,73,No,8,7,8,46
5,58,Yes,5,2,7,41
9,59,Yes,7,9,18,58
3,62,No,7,3,6,40
9,93,Yes,8,3,12,92
5,98,No,8,5,10,86
9,79,Yes,6,8,17,77
6,64,No,9,9,15,52
9,54,No,8,2,11,47
7,77,No,8,3,10,70
7,62,No,8,5,12,57
8,91,No,9,5,13,90
7,41,Yes,5,6,13,32
9,96,No,7,0,9,93
9,96,No,7,8,17,94
6,54,Yes,8,1,7,42
7,91,No,9,3,10,82
2,83,Yes,6,2,4,58
9,74,Yes,8,2,11,68
1,49,No,9,4,5,25
1,53,Yes,9,6,7,30
3,66,Yes,6,6,9,46
6,93,Yes,9,6,12,86
5,53,No,7,2,7,42
2,74,Yes,6,8,10,49
9,72,No,6,5,14,70
4,91,No,4,9,13,74
4,40,Yes,6,7,11,26
5,73,No,6,0,5,56
8,58,Yes,5,3,11,54
4,63,Yes,7,6,10,48
5,81,No,8,8,13,70
4,43,No,4,2,6,22
6,75,No,6,5,11,62
3,52,Yes,5,7,10,33
8,97,Yes,5,2,10,93
6,71,Yes,9,5,11,62
5,48,No,8,8,13,31
2,78,Yes,8,8,10,60
7,55,Yes,7,5,12,50
2,89,Yes,9,4,6,67
1,42,Yes,6,0,1,17
7,91,No,5,2,9,82
5,59,Yes,4,2,7,41
1,49,No,7,3,4,24
4,95,Yes,6,4,8,78
4,97,Yes,9,7,11,80
7,97,Yes,8,8,15,93
9,61,No,9,6,15,64
2,87,No,6,9,11,60
1,42,No,9,5,6,18
2,50,Yes,8,2,4,28
7,64,Yes,6,8,15,54
6,81,No,4,9,15,71
4,87,Yes,7,0,4,68
1,47,Yes,9,8,9,23
1,48,No,8,2,3,20
5,54,Yes,4,8,13,37
1,71,Yes,5,9,10,47
7,92,Yes,4,0,7,81
1,42,No,4,7,8,18
1,43,Yes,4,5,6,16
2,69,No,8,8,10,49
3,52,Yes,5,3,6,33
1,83,No,7,4,5,60
9,60,No,4,5,14,55
8,80,No,8,8,16,75
5,96,No,8,5,10,81
2,85,Yes,7,8,10,64
5,58,No,6,1,6,41
6,78,Yes,5,3,9,68
1,87,Yes,5,2,3,59
4,61,No,9,3,7,44
9,59,Yes,4,0,9,55
2,76,Yes,6,1,3,54
5,70,Yes,5,3,8,53
1,49,Yes,9,9,10,24
4,57,No,4,3,7,37
4,82,Yes,6,4,8,65
6,78,Yes,8,8,14,69
9,85,Yes,4,0,9,82
3,59,Yes,6,7,10,39
9,57,Yes,7,2,11,54
6,50,No,5,8,14,36
7,61,Yes,4,7,14,55
2,98,No,9,7,9,78
6,83,Yes,8,8,14,73
6,57,No,9,3,9,49
2,97,Yes,4,4,6,74
2,73,Yes,5,6,8,51
2,62,No,5,1,3,37
1,40,No,6,6,7,16
5,94,No,9,2,7,84
8,49,Yes,9,5,13,47
2,92,No,8,5,7,70
5,40,No,6,5,10,28
8,77,No,8,9,17,72
5,78,Yes,4,1,6,60
2,88,Yes,4,8,10,67
3,48,Yes,9,7,10,33
6,70,No,6,6,12,58
5,46,Yes,7,8,13,36
4,56,Yes,5,3,7,35
4,74,Yes,6,1,5,56
5,87,Yes,6,3,8,71
2,76,No,4,9,11,51
9,91,Yes,5,2,11,88
2,57,No,6,1,3,36
2,72,No,4,1,3,50
9,43,No,4,7,16,42
3,62,No,9,4,7,44
7,50,No,9,5,12,42
4,91,No,6,7,11,75
6,48,Yes,6,6,12,34
4,69,No,4,6,10,54
7,47,Yes,9,6,13,36
1,79,No,6,6,7,53
3,44,Yes,5,7,10,24
3,51,No,4,0,3,30
1,40,Yes,4,2,3,13
6,54,Yes,6,0,6,43
9,64,No,6,7,16,56
8,57,No,6,1,9,50
7,77,No,5,6,13,67
8,81,No,4,5,13,74
6,85,Yes,7,0,6,73
9,92,Yes,5,5,14,90
3,65,No,5,8,11,42
9,79,No,9,2,11,77
4,98,Yes,4,6,10,84
7,42,No,7,3,10,37
9,93,Yes,4,0,9,91
2,61,No,5,6,8,34
2,65,No,6,0,2,40
9,58,Yes,4,3,12,53
3,83,Yes,4,8,11,63
9,83,No,6,4,13,82
5,86,Yes,7,6,11,73
6,99,No,7,6,12,86
2,78,Yes,4,2,4,56
8,98,No,6,7,15,94
9,75,No,9,0,9,74
2,60,No,4,3,5,37
6,80,Yes,6,9,15,69
6,93,Yes,5,3,9,79
8,87,Yes,9,1,9,83
5,65,Yes,6,5,10,50
9,52,No,4,0,9,47
1,75,Yes,8,2,3,53
9,63,Yes,7,8,17,62
7,80,Yes,4,9,16,75
4,65,No,6,5,9,48
3,60,Yes,9,1,4,40
6,57,Yes,9,8,14,45
1,54,No,6,1,2,27
3,54,No,7,6,9,32
2,45,No,4,0,2,20
9,82,No,9,4,13,80
3,70,No,9,6,9,51
2,67,No,8,2,4,44
4,47,No,5,3,7,29
2,68,Yes,8,4,6,46
1,60,No,5,2,3,37
6,56,No,9,5,11,44
8,95,No,5,2,10,90
2,96,No,4,7,9,75
9,88,No,9,6,15,84
3,63,Yes,9,0,3,44
8,97,Yes,5,1,9,91
8,99,Yes,6,3,11,94
3,89,Yes,5,4,7,69
3,75,Yes,5,9,12,57
6,70,Yes,7,3,9,55
1,86,Yes,7,3,4,61
4,73,No,4,8,12,54
1,41,No,4,3,4,12
3,81,No,6,3,6,62
9,42,No,7,3,12,40
5,69,No,8,1,6,57
5,47,No,4,7,12,33
4,91,Yes,4,3,7,71
3,46,No,7,4,7,26
5,51,No,7,7,12,39
4,97,No,6,3,7,74
8,58,Yes,7,4,12,56
4,65,Yes,5,4,8,45
8,67,Yes,9,5,13,61
6,54,No,8,6,12,45
5,53,No,9,2,7,43
4,87,No,5,9,13,68
4,98,Yes,5,2,6,79
4,53,Yes,9,8,12,40
9,42,No,5,0,9,37
4,89,Yes,4,9,13,72
9,68,No,9,7,16,67
6,99,Yes,5,9,15,93
7,93,Yes,4,2,9,85
3,45,Yes,7,4,7,26
8,88,No,8,2,10,84
3,62,Yes,8,9,12,45
1,67,No,5,0,1,41
5,53,No,8,9,14,39
2,53,No,4,4,6,28
6,59,Yes,7,7,13,48
9,52,Yes,5,4,13,46
1,66,Yes,6,3,4,38
4,99,No,9,8,12,87
1,74,Yes,8,0,1,50
1,84,Yes,8,4,5,63
8,95,No,5,0,8,89
2,41,No,9,5,7,19
1,80,No,9,9,10,56
8,84,Yes,8,8,16,82
4,79,Yes,8,1,5,60
3,87,No,6,3,6,67
4,63,Yes,9,7,11,50
5,68,No,4,2,7,52
1,42,Yes,5,6,7,17
1,84,No,5,6,7,61
3,43,Yes,6,1,4,22
6,89,No,6,9,15,79
1,41,No,4,3,4,15
2,59,No,7,0,2,34
7,93,Yes,5,7,14,83
1,92,Yes,9,9,10,71
7,54,Yes,8,9,16,47
4,88,No,4,8,12,70
6,71,No,5,0,6,58
8,81,No,9,6,14,74
9,40,No,4,0,9,34
6,77,No,7,0,6,66
9,74,No,9,8,17,73
4,90,No,5,9,13,72
6,46,No,8,9,15,34
8,84,No,9,5,13,80
9,52,Yes,5,0,9,49
3,88,No,4,6,9,69
2,40,Yes,7,2,4,16
6,53,No,9,9,15,46
4,68,Yes,4,3,7,50
1,97,No,4,3,4,67
8,42,Yes,6,7,15,37
9,85,No,4,0,9,78
9,63,No,9,7,16,62
2,40,No,7,8,10,18
9,87,Yes,8,6,15,83
7,49,No,6,0,7,42
5,52,Yes,4,6,11,36
7,75,Yes,9,5,12,64
9,48,Yes,5,4,13,47
8,53,Yes,6,4,12,48
6,75,Yes,7,0,6,63
4,49,No,5,5,9,31
1,79,Yes,7,3,4,54
6,62,Yes,5,0,6,46
3,74,Yes,8,7,10,53
6,94,Yes,7,7,13,86
6,46,No,5,3,9,34
4,81,No,7,6,10,66
2,74,No,6,2,4,53
9,41,Yes,7,7,16,32
2,54,Yes,9,6,8,32
3,48,Yes,7,4,7,26
1,86,No,5,4,5,59
7,56,Yes,7,8,15,45
1,78,No,8,5,6,54
9,91,Yes,4,5,14,89
1,57,Yes,6,1,2,35
5,54,No,9,4,9,40
7,57,Yes,5,3,10,49
3,63,No,7,9,12,46
9,62,Yes,7,2,11,63
8,51,No,7,8,16,43
3,62,Yes,6,6,9,44
5,60,Yes,9,3,8,48
7,65,Yes,4,8,15,53
4,47,Yes,8,8,12,32
5,69,Yes,9,6,11,58
3,73,No,8,4,7,50
9,41,No,9,8,17,39
9,44,Yes,5,6,15,41
7,70,No,4,8,15,61
2,72,No,4,2,4,49
7,93,No,6,8,15,84
7,43,No,9,0,7,32
5,45,Yes,7,4,9,32
9,62,No,4,1,10,60
3,84,No,9,0,3,67
4,58,Yes,7,2,6,46
1,82,Yes,6,6,7,56
6,84,Yes,9,2,8,74
4,47,Yes,9,9,13,28
1,78,Yes,5,9,10,52
2,52,Yes,9,8,10,28
3,40,Yes,5,2,5,18
9,45,Yes,7,5,14,45
8,46,No,7,1,9,41
7,87,Yes,4,7,14,78
4,66,No,6,9,13,48
1,54,Yes,5,4,5,26
8,91,Yes,4,1,9,86
4,73,No,8,6,10,56
3,97,Yes,4,2,5,77
9,96,Yes,7,4,13,95
4,62,No,8,8,12,47
4,87,No,4,0,4,62
9,88,No,9,1,10,87
2,63,No,6,4,6,40
5,54,No,5,3,8,35
4,74,No,9,0,4,60
9,43,Yes,8,6,15,41
5,83,Yes,6,8,13,67
9,76,Yes,4,0,9,70
9,56,Yes,9,7,16,55
2,70,Yes,7,8,10,54
9,77,No,7,1,10,72
3,49,No,6,0,3,26
4,93,Yes,7,5,9,77
1,89,No,5,6,7,67
1,66,Yes,6,1,2,39
1,81,No,6,4,5,54
9,45,Yes,7,4,13,43
8,95,Yes,6,6,14,89
5,45,Yes,4,0,5,28
5,91,No,8,9,14,80
9,54,No,9,7,16,51
3,43,Yes,8,4,7,23
3,96,No,9,2,5,79
7,87,Yes,7,8,15,77
9,93,Yes,5,2,11,89
6,95,No,5,6,12,80
2,79,Yes,7,9,11,57
1,46,Yes,7,6,7,20
2,90,Yes,6,9,11,68
1,97,No,5,7,8,71
9,88,Yes,8,9,18,88
8,92,Yes,7,7,15,85
7,84,Yes,8,3,10,77
3,86,Yes,9,0,3,66
8,65,No,8,3,11,61
2,97,Yes,5,5,7,74
2,70,Yes,9,9,11,48
3,41,No,8,5,8,18
7,67,No,6,5,12,59
1,81,No,6,6,7,55
8,52,No,5,0,8,47
7,57,No,6,9,16,52
4,69,No,7,0,4,50
5,94,Yes,9,6,11,77
1,50,Yes,5,3,4,25
4,52,No,9,5,9,35
1,90,Yes,8,5,6,65
1,63,No,7,8,9,40
1,96,Yes,5,1,2,70
7,68,No,8,3,10,61
7,95,No,8,3,10,89
4,93,Yes,8,6,10,77
2,44,No,8,0,2,22
3,74,Yes,8,4,7,55
8,58,No,5,3,11,52
8,94,No,6,1,9,88
6,52,Yes,8,4,10,44
9,44,No,7,8,17,39
9,83,Yes,5,7,16,80
4,53,Yes,4,8,12,35
1,77,Yes,6,6,7,52
1,61,Yes,7,9,10,34
5,48,Yes,8,6,11,33
2,88,No,5,1,3,64
6,79,No,5,2,8,65
7,65,Yes,8,9,16,55
1,84,No,7,7,8,58
6,44,Yes,5,1,7,29
8,68,No,9,6,14,65
5,93,Yes,6,5,10,80
7,61,No,7,9,16,55
6,88,Yes,8,3,9,78
4,42,No,7,3,7,22
7,67,Yes,9,2,9,53
9,77,Yes,7,5,14,77
7,53,No,4,2,9,41
5,86,Yes,8,8,13,69
7,53,Yes,6,3,10,47
3,82,No,8,3,6,64
2,50,No,4,1,3,28
5,48,Yes,8,1,6,35
4,77,Yes,8,6,10,63
5,86,Yes,6,4,9,71
8,83,Yes,4,2,10,78
4,45,No,8,5,9,32
9,40,Yes,9,5,14,40
7,64,Yes,8,0,7,55
7,55,No,5,2,9,42
8,91,No,8,4,12,88
6,54,Yes,6,6,12,43
8,73,No,5,3,11,66
3,56,No,9,7,10,33
1,42,No,9,2,3,12
6,42,Yes,9,5,11,32
1,76,Yes,4,5,6,48
9,56,Yes,9,8,17,56
2,94,No,7,3,5,73
2,88,Yes,6,6,8,65
7,91,Yes,4,9,16,83
2,77,Yes,5,0,2,53
8,40,No,7,0,8,39
6,46,Yes,4,1,7,32
7,65,Yes,6,3,10,55
7,86,Yes,5,5,12,76
6,78,Yes,6,3,9,69
9,58,No,6,5,14,54
9,91,Yes,5,1,10,89
7,93,Yes,9,8,15,87
9,69,No,8,2,11,66
3,82,No,6,6,9,65
3,94,No,9,0,3,71
1,53,No,5,7,8,27
5,52,No,6,3,8,38
4,59,Yes,8,4,8,43
2,65,No,5,6,8,38
9,66,No,4,2,11,59
3,64,No,4,8,11,44
8,48,Yes,9,8,16,39
6,80,Yes,4,7,13,67
5,87,Yes,7,0,5,70
1,51,No,6,1,2,24
4,49,Yes,6,1,5,31
3,45,No,5,2,5,24
1,89,No,7,1,2,61
5,73,Yes,6,0,5,59
6,98,Yes,5,4,10,87
2,91,Yes,8,5,7,68
3,80,No,6,6,9,62
6,58,Yes,9,9,15,50
4,45,Yes,6,6,10,27
9,41,Yes,8,1,10,36
5,54,Yes,8,6,11,43
4,56,Yes,6,1,5,35
2,55,No,8,1,3,29
6,67,No,5,5,11,56
2,60,Yes,6,5,7,41
7,47,No,6,7,14,37
3,49,No,4,4,7,26
9,49,No,9,4,13,46
5,89,Yes,6,9,14,75
8,49,No,4,0,8,40
6,48,Yes,8,3,9,36
8,67,No,9,0,8,62
3,63,Yes,9,9,12,47
3,58,No,8,4,7,39
5,72,No,5,7,12,57
3,43,Yes,4,0,3,20
8,95,Yes,6,2,10,87
8,42,No,4,0,8,31
2,81,Yes,8,5,7,57
4,51,Yes,8,9,13,37
1,57,Yes,5,0,1,29
4,62,Yes,9,9,13,48
4,59,No,9,2,6,41
9,45,Yes,8,4,13,43
3,92,No,4,4,7,70
2,73,No,9,1,3,54
9,81,Yes,6,2,11,77
9,41,Yes,6,8,17,40
1,69,Yes,4,0,1,39
6,48,Yes,5,0,6,38
8,66,No,6,1,9,61
3,81,No,4,7,10,59
9,73,Yes,4,5,14,68
2,79,No,8,3,5,59
6,63,Yes,9,6,12,55
1,88,No,8,5,6,63
7,56,No,9,8,15,47
3,68,No,5,5,8,49
7,75,Yes,5,1,8,64
4,89,Yes,5,2,6,72
9,51,No,4,8,17,46
5,70,Yes,4,6,11,55
3,88,Yes,8,5,8,73
8,48,No,6,4,12,41
6,58,Yes,9,2,8,50
2,85,Yes,9,3,5,61
3,85,No,5,0,3,60
8,56,No,9,4,12,52
7,41,No,7,6,13,31
6,79,No,5,1,7,66
1,44,Yes,9,7,8,16
9,98,Yes,8,9,18,93
3,78,No,9,5,8,59
5,93,No,4,9,14,78
7,87,Yes,8,2,9,79
7,55,Yes,8,1,8,50
3,56,Yes,8,7,10,38
4,93,No,7,3,7,80
7,66,No,7,6,13,58
8,46,No,9,6,14,44
2,91,No,5,9,11,70
9,47,Yes,9,8,17,45
7,47,No,9,9,16,40
8,62,No,9,7,15,57
6,71,Yes,4,7,13,61
6,82,No,8,6,12,72
9,86,Yes,6,9,18,83
4,57,No,5,4,8,36
5,77,Yes,5,8,13,61
9,93,Yes,8,6,15,90
1,51,Yes,5,2,3,22
4,54,No,8,5,9,35
7,67,No,5,2,9,59
9,94,No,9,5,14,89
6,77,No,4,7,13,66
8,89,No,5,8,16,88
9,95,No,5,1,10,91
4,70,Yes,6,5,9,53
1,91,No,4,2,3,64
8,48,No,9,6,14,40
2,47,Yes,4,3,5,24
1,85,Yes,4,4,5,59
7,58,No,5,9,16,49
9,90,Yes,7,5,14,85
9,47,No,5,7,16,47
3,73,Yes,8,1,4,54
6,96,No,6,3,9,82
7,43,Yes,4,3,10,31
9,70,Yes,8,5,14,67
2,77,No,9,3,5,58
8,42,No,8,4,12,36
7,74,Yes,7,4,11,66
4,58,Yes,4,7,11,39
2,82,Yes,5,3,5,61
8,68,Yes,4,5,13,64
5,49,No,6,6,11,31
6,51,Yes,4,7,13,39
7,85,Yes,8,8,15,78
1,69,No,8,9,10,43
8,69,No,5,7,15,62
4,99,No,5,3,7,80
9,57,No,5,3,12,51
1,63,No,9,9,10,40
2,71,No,6,4,6,48
6,48,Yes,9,2,8,38
1,86,Yes,9,1,2,61
4,63,Yes,9,1,5,42
8,65,No,4,8,16,57
5,42,No,7,7,12,26
9,62,Yes,4,5,14,58
6,50,Yes,5,8,14,40
1,49,No,6,4,5,26
6,89,No,9,9,15,78
6,75,Yes,4,0,6,62
6,99,Yes,8,7,13,90
8,52,Yes,9,2,10,50
6,68,Yes,4,8,14,57
5,77,Yes,8,0,5,62
2,98,No,4,2,4,74
4,92,Yes,4,0,4,74
5,52,Yes,9,0,5,40
4,96,No,4,5,9,81
2,65,Yes,5,3,5,45
7,59,No,8,9,16,50
2,44,No,6,3,5,17
1,59,Yes,7,4,5,31
5,53,Yes,9,2,7,40
1,84,No,8,1,2,61
1,53,No,5,9,10,26
1,47,No,8,7,8,20
6,87,Yes,6,6,12,73
9,52,Yes,9,9,18,55
1,63,Yes,8,3,4,37
5,54,Yes,5,1,6,35
9,90,Yes,9,8,17,90
9,40,No,5,7,16,36
1,61,Yes,9,3,4,38
8,73,Yes,7,4,12,65
1,89,No,6,9,10,66
8,90,Yes,7,5,13,88
1,79,Yes,4,3,4,53
5,42,Yes,5,1,6,27
8,94,No,7,4,12,90
6,65,No,5,0,6,50
9,53,Yes,9,6,15,49
1,97,Yes,5,8,9,71
9,80,Yes,4,2,11,72
1,47,No,5,5,6,21
3,88,No,9,8,11,73
1,94,Yes,9,3,4,68
3,94,Yes,7,5,8,74
2,95,Yes,6,2,4,72
2,55,Yes,8,8,10,38
9,81,No,7,6,15,78
8,60,No,4,6,14,55
1,49,Yes,8,3,4,24
4,96,No,5,5,9,72
1,64,No,7,7,8,38
1,95,Yes,8,5,6,73
4,77,Yes,7,5,9,60
2,61,Yes,5,3,5,38
3,88,Yes,9,7,10,74
9,87,No,7,9,18,86
2,86,Yes,4,7,9,62
4,93,Yes,8,8,12,80
1,85,Yes,8,5,6,62
2,43,Yes,8,1,3,22
5,43,No,7,3,8,28
1,69,Yes,5,3,4,41
7,41,Yes,7,7,14,34
4,68,No,7,4,8,52
6,82,Yes,9,3,9,71
8,75,Yes,8,7,15,68
6,60,Yes,5,2,8,47
2,99,No,6,1,3,73
1,60,Yes,5,3,4,33
8,87,Yes,7,0,8,83
8,60,Yes,4,0,8,48
9,43,No,5,4,13,39
6,40,Yes,8,0,6,29
1,65,Yes,4,3,4,36
9,95,Yes,6,7,16,94
3,90,No,6,7,10,73
6,41,No,4,1,7,28
9,48,Yes,6,2,11,49
3,94,Yes,4,2,5,73
5,96,No,7,0,5,83
5,84,Yes,4,2,7,73
7,57,No,7,7,14,50
4,87,No,8,5,9,74
4,87,No,8,4,8,71
7,96,Yes,6,9,16,92
9,81,No,9,8,17,78
4,80,No,9,6,10,64
4,50,Yes,4,5,9,37
6,64,Yes,7,4,10,49
6,65,Yes,8,4,10,53
7,97,No,8,9,16,95
1,75,No,8,8,9,50
3,81,Yes,6,9,12,62
9,74,No,8,5,14,74
6,77,Yes,9,3,9,70
6,42,Yes,5,3,9,29
5,98,Yes,6,3,8,81
3,80,Yes,4,5,8,58
5,74,Yes,5,0,5,57
1,89,No,6,8,9,61
3,79,No,6,1,4,56
4,61,Yes,7,1,5,44
5,47,No,5,4,9,30
9,54,No,5,3,12,53
4,84,Yes,9,2,6,67
3,46,No,5,4,7,21
1,58,No,8,6,7,35
6,79,Yes,9,9,15,77
7,81,No,8,1,8,72
8,56,No,9,5,13,52
1,40,No,4,3,4,15
4,84,No,9,1,5,67
5,68,No,4,0,5,55
2,97,Yes,9,7,9,73
1,52,Yes,4,4,5,25
8,95,Yes,8,9,17,90
6,87,Yes,9,1,7,74
5,68,Yes,7,7,12,53
9,80,No,9,2,11,79
2,81,No,4,6,8,59
8,45,Yes,6,1,9,40
9,44,Yes,8,6,15,39
1,73,Yes,7,3,4,49
7,50,No,6,9,16,41
8,48,No,6,0,8,39
3,77,No,8,4,7,57
4,79,No,9,3,7,66
3,80,No,5,7,10,59
7,48,No,7,0,7,40
9,47,Yes,9,1,10,47
3,83,No,8,4,7,65
6,97,Yes,5,9,15,86
8,79,Yes,8,9,17,75
6,42,No,8,1,7,30
2,52,No,6,0,2,26
7,58,No,9,5,12,49
2,73,No,8,9,11,52
2,71,No,9,3,5,47
2,88,No,5,4,6,64
1,55,No,6,2,3,28
1,75,No,5,9,10,48
7,57,Yes,5,5,12,47
5,53,Yes,6,3,8,37
3,69,No,9,5,8,54
1,41,Yes,5,4,5,18
6,52,No,4,1,7,37
1,66,Yes,9,3,4,41
9,98,Yes,8,1,10,96
2,92,No,6,4,6,69
1,91,No,6,2,3,64
7,56,No,9,5,12,48
6,70,Yes,4,4,10,59
6,54,Yes,4,1,7,39
5,96,No,4,9,14,80
4,59,Yes,4,7,11,38
4,44,No,7,5,9,26
3,46,Yes,6,8,11,27
8,57,No,5,2,10,50
7,95,Yes,6,3,10,89
9,50,No,6,7,16,45
1,71,No,6,6,7,42
7,89,No,4,7,14,80
4,66,Yes,4,8,12,48
7,65,No,7,7,14,59
1,76,Yes,9,7,8,53
5,84,No,6,5,10,72
3,67,No,8,1,4,46
5,89,No,9,6,11,75
4,41,Yes,7,3,7,25
2,59,Yes,4,2,4,36
4,43,Yes,6,3,7,24
3,52,No,4,3,6,31
1,63,Yes,9,2,3,39
8,87,No,5,8,16,81
5,77,No,4,2,7,63
4,97,No,4,1,5,81
5,79,No,7,0,5,63
4,87,No,5,0,4,69
3,84,Yes,9,4,7,66
5,94,Yes,8,4,9,80
4,68,No,8,8,12,52
1,97,No,8,3,4,68
3,75,Yes,6,4,7,57
8,41,No,8,5,13,37
7,80,No,6,9,16,68
2,57,No,9,6,8,35
1,88,No,9,8,9,65
3,47,Yes,4,5,8,28
5,97,No,8,0,5,82
1,54,Yes,7,7,8,29
3,80,Yes,9,1,4,62
3,56,Yes,5,8,11,35
5,62,Yes,5,6,11,51
3,41,No,9,6,9,22
9,45,No,4,9,18,42
1,68,No,5,9,10,45
4,66,Yes,5,4,8,48
4,76,Yes,4,7,11,61
1,88,Yes,4,9,10,59
2,73,No,4,0,2,50
1,57,No,7,2,3,33
6,81,No,4,8,14,65
3,49,Yes,4,0,3,26
7,77,Yes,4,7,14,69
5,98,No,9,5,10,87
9,83,Yes,8,9,18,85
7,56,Yes,9,4,11,46
4,98,No,8,5,9,82
5,52,Yes,7,4,9,36
5,91,Yes,7,8,13,77
5,99,No,5,1,6,85
9,87,Yes,9,9,18,85
3,81,Yes,8,5,8,62
6,66,Yes,7,3,9,54
8,92,Yes,7,2,10,89
9,41,No,9,4,13,35
7,73,No,5,1,8,65
3,70,Yes,4,2,5,52
1,62,No,6,6,7,37
4,46,No,5,0,4,27
6,77,No,6,1,7,60
3,72,Yes,5,2,5,52
1,51,Yes,5,9,10,28
6,84,No,4,6,12,72
1,51,No,7,3,4,23
9,58,No,8,7,16,59
1,48,No,5,7,8,20
6,49,Yes,4,0,6,38
1,56,No,6,4,5,31
7,89,Yes,9,0,7,81
3,79,Yes,9,6,9,66
6,78,Yes,7,3,9,68
7,80,Yes,9,7,14,75
1,49,Yes,5,7,8,24
1,51,Yes,6,8,9,26
5,54,Yes,5,5,10,39
6,70,No,9,6,12,61
9,54,Yes,8,6,15,52
1,67,No,9,4,5,38
4,43,No,8,6,10,25
8,75,No,9,8,16,73
9,94,No,7,3,12,93
3,40,No,6,1,4,16
2,97,Yes,8,7,9,75
4,83,Yes,4,6,10,64
2,96,No,7,5,7,77
1,73,No,5,6,7,44
3,86,No,9,2,5,66
7,56,Yes,6,5,12,48
1,78,No,6,9,10,50
2,77,Yes,9,6,8,56
1,83,Yes,4,6,7,55
8,90,No,8,4,12,83
5,72,Yes,9,2,7,58
8,99,Yes,6,1,9,93
3,60,Yes,4,6,9,38
7,65,No,4,3,10,55
8,85,No,5,1,9,80
6,75,No,4,7,13,64
7,44,No,7,1,8,37
2,72,No,6,5,7,49
8,40,No,7,3,11,33
5,92,No,4,8,13,78
7,45,No,4,4,11,31
1,76,Yes,7,3,4,53
5,41,No,5,7,12,25
1,96,Yes,4,2,3,69
8,92,Yes,7,8,16,89
4,98,No,7,7,11,80
4,98,Yes,6,7,11,80
2,44,Yes,5,9,11,22
5,65,No,8,4,9,52
1,80,Yes,7,0,1,59
9,90,No,6,9,18,88
5,92,Yes,8,8,13,81
6,86,Yes,6,1,7,79
2,52,No,6,0,2,28
1,51,Yes,9,5,6,28
4,44,Yes,5,0,4,19
7,41,No,4,9,16,31
6,98,No,5,9,15,87
1,43,Yes,8,9,10,17
1,98,Yes,9,6,7,75
8,66,No,5,6,14,61
4,89,Yes,4,0,4,72
5,92,No,5,9,14,78
7,49,No,5,4,11,36
8,52,No,5,2,10,45
7,83,Yes,7,1,8,74
2,41,Yes,7,4,6,17
4,65,Yes,5,4,8,47
1,54,No,4,1,2,25
9,85,Yes,4,5,14,81
3,96,No,4,6,9,74
3,49,Yes,4,0,3,30
9,61,No,9,2,11,59
3,79,No,9,3,6,60
8,64,Yes,6,1,9,58
2,54,No,5,9,11,28
3,52,Yes,5,4,7,33
2,47,Yes,6,3,5,30
1,60,Yes,4,1,2,31
2,60,Yes,8,0,2,36
8,61,Yes,8,7,15,56
9,85,No,6,1,10,82
2,72,Yes,8,3,5,50
7,84,No,7,9,16,76
5,66,Yes,5,4,9,52
3,79,No,8,1,4,60
9,89,No,9,9,18,91
6,61,Yes,9,8,14,52
1,69,No,7,1,2,43
5,48,Yes,5,5,10,32
7,84,Yes,7,6,13,77
4,74,Yes,5,5,9,55
8,57,No,5,3,11,52
5,81,No,8,0,5,68
9,44,No,9,1,10,41
9,66,No,6,9,18,63
9,96,Yes,8,9,18,99
1,45,Yes,4,5,6,17
2,71,No,7,7,9,47
3,47,No,4,2,5,24
4,95,Yes,5,6,10,80
9,78,No,8,8,17,79
6,60,Yes,4,3,9,49
1,57,No,4,6,7,27
9,53,No,9,6,15,51
6,54,No,4,9,15,41
4,81,Yes,9,8,12,67
4,65,Yes,9,2,6,48
3,92,No,5,0,3,72
7,83,No,9,7,14,75
3,71,No,5,3,6,48
2,78,No,9,1,3,58
8,67,No,9,4,12,62
4,99,No,5,3,7,83
8,78,No,4,0,8,68
1,82,No,7,6,7,55
5,71,Yes,8,3,8,55
9,52,Yes,8,7,16,49
1,54,Yes,5,8,9,27
4,57,Yes,4,7,11,38
6,78,No,7,0,6,66
8,45,Yes,6,7,15,37
3,94,Yes,5,4,7,72
5,50,No,6,0,5,34
7,71,Yes,8,8,15,68
1,79,Yes,8,8,9,56
7,59,Yes,7,6,13,52
8,72,Yes,7,6,14,67
8,79,Yes,6,0,8,69
9,47,No,8,8,17,45
6,90,No,7,0,6,76
6,74,No,7,6,12,65
2,44,Yes,8,8,10,26
3,74,Yes,8,8,11,54
4,86,Yes,4,4,8,68
4,53,No,9,5,9,34
8,60,Yes,7,1,9,56
1,86,Yes,6,1,2,63
4,63,Yes,5,9,13,47
4,56,Yes,5,8,12,40
1,57,No,8,0,1,31
3,73,No,9,9,12,56
5,51,Yes,6,4,9,36
6,55,No,4,6,12,41
9,43,No,7,9,18,43
9,64,No,4,5,14,61
9,73,Yes,6,5,14,69
1,67,No,4,5,6,44
9,85,No,8,7,16,82
8,50,Yes,5,6,14,48
2,52,No,8,4,6,27
1,70,No,7,9,10,45
1,99,No,8,1,2,75
6,64,Yes,6,9,15,54
9,78,Yes,6,5,14,76
7,49,No,7,9,16,44
5,63,Yes,7,4,9,50
2,40,Yes,5,3,5,17
1,92,Yes,4,9,10,66
2,64,No,5,4,6,42
1,67,No,8,8,9,42
3,75,Yes,4,1,4,56
6,57,No,7,5,11,48
8,45,Yes,6,8,16,40
3,41,Yes,8,9,12,24
9,42,No,5,4,13,38
5,85,Yes,9,5,10,73
7,47,Yes,9,9,16,40
8,70,Yes,7,3,11,62
3,87,Yes,4,4,7,65
2,58,No,9,7,9,37
2,89,Yes,4,0,2,68
5,45,No,6,0,5,30
1,53,Yes,7,9,10,31
2,42,No,7,3,5,15
9,87,Yes,8,9,18,89
7,40,Yes,8,2,9,33
6,83,No,4,4,10,72
9,69,No,9,9,18,64
7,85,Yes,9,7,14,78
5,58,Yes,5,0,5,40
9,93,Yes,4,4,13,91
6,58,Yes,9,4,10,49
6,48,Yes,8,1,7,38
4,46,No,8,4,8,28
1,85,No,8,7,8,62
5,76,Yes,4,9,14,62
9,89,No,7,6,15,89
8,80,No,5,1,9,74
8,92,Yes,5,5,13,85
5,46,No,8,9,14,33
9,48,Yes,6,0,9,41
3,43,No,4,9,12,24
3,64,No,9,9,12,47
1,88,No,9,2,3,65
9,51,No,7,5,14,50
6,45,No,8,8,14,35
2,57,Yes,6,0,2,30
8,79,No,8,5,13,76
9,60,Yes,6,1,10,55
9,54,No,5,8,17,49
2,42,No,6,1,3,19
2,41,No,5,2,4,15
7,95,Yes,5,1,8,86
4,94,No,4,3,7,77
1,80,No,6,3,4,55
8,79,Yes,7,9,17,77
2,98,Yes,7,0,2,74
3,43,Yes,6,7,10,23
5,71,No,4,4,9,56
3,41,No,7,7,10,18
7,85,No,8,5,12,76
7,68,No,7,1,8,57
2,41,Yes,4,6,8,13
7,73,Yes,5,9,16,64
6,66,No,5,8,14,54
9,99,Yes,5,6,15,97
9,93,Yes,4,4,13,89
2,78,Yes,5,3,5,53
7,83,No,5,7,14,74
5,77,Yes,4,5,10,61
6,57,No,8,4,10,41
1,75,No,7,6,7,48
7,58,No,4,2,9,48
6,66,Yes,4,8,14,54
4,84,Yes,6,3,7,67
1,59,Yes,5,3,4,34
9,60,Yes,9,7,16,60
4,62,No,8,5,9,46
2,69,No,9,0,2,45
8,64,No,6,1,9,56
2,70,Yes,8,8,10,49
5,66,Yes,5,5,10,49
6,73,Yes,9,6,12,65
8,47,No,5,8,16,39
1,58,No,5,2,3,33
1,80,Yes,7,4,5,55
4,65,No,8,4,8,50
5,67,No,8,9,14,52
9,43,Yes,6,6,15,43
7,70,Yes,4,1,8,58
7,55,No,5,3,10,45
8,90,Yes,5,3,11,81
5,49,No,9,7,12,36
5,77,Yes,6,9,14,64
1,87,No,8,2,3,57
9,49,Yes,7,1,10,46
6,84,Yes,8,8,14,76
9,48,Yes,7,3,12,43
3,78,No,7,8,11,58
5,75,No,8,5,10,61
2,90,Yes,9,0,2,72
5,97,No,5,2,7,82
8,75,No,7,6,14,69
2,58,Yes,9,8,10,35
8,99,Yes,6,7,15,91
4,58,Yes,6,4,8,40
1,51,No,7,7,8,26
5,52,Yes,5,1,6,34
1,64,No,7,2,3,35
7,75,No,6,7,14,67
8,64,No,6,8,16,60
3,67,Yes,8,9,12,48
3,81,Yes,5,7,10,62
7,92,No,8,3,10,84
4,78,No,9,5,9,67
3,69,Yes,9,4,7,50
8,44,Yes,9,3,11,42
3,56,Yes,4,8,11,37
7,57,Yes,9,9,16,50
2,82,Yes,7,2,4,61
1,86,Yes,8,0,1,61
6,60,Yes,9,6,12,48
8,61,Yes,5,9,17,56
1,78,Yes,9,7,8,54
9,89,No,7,2,11,86
3,97,Yes,7,2,5,77
3,96,Yes,7,5,8,77
4,45,No,7,1,5,25
1,89,Yes,7,5,6,67
9,55,Yes,5,4,13,51
3,41,No,4,6,9,20
4,90,Yes,6,8,12,74
1,40,No,4,8,9,12
4,96,No,6,0,4,78
1,69,Yes,8,6,7,48
5,97,No,7,2,7,79
5,82,No,8,3,8,66
7,91,No,8,1,8,82
8,76,No,6,0,8,67
4,87,Yes,5,9,13,75
7,62,No,7,2,9,52
4,40,No,9,9,13,25
3,58,Yes,8,8,11,39
6,85,No,4,0,6,66
4,42,Yes,7,2,6,24
3,41,No,5,4,7,17
9,95,Yes,7,2,11,93
5,76,No,9,3,8,62
7,56,Yes,9,3,10,47
6,67,No,8,0,6,55
5,57,Yes,4,5,10,41
7,72,Yes,8,6,13,67
6,54,Yes,5,6,12,43
2,61,Yes,6,5,7,42
3,80,Yes,9,6,9,64
2,66,No,4,2,4,42
3,94,No,9,4,7,77
1,76,Yes,5,6,7,52
8,71,Yes,5,9,17,62
6,99,No,9,4,10,90
2,84,No,8,9,11,60
8,58,Yes,9,1,9,49
6,67,No,8,5,11,54
7,67,Yes,9,6,13,61
1,95,Yes,8,1,2,67
7,49,Yes,6,9,16,42
3,59,No,7,7,10,43
8,64,Yes,7,4,12,58
6,60,No,8,7,13,50
4,53,No,8,2,6,34
8,61,No,6,1,9,51
9,92,No,7,6,15,89
2,65,Yes,6,4,6,41
6,83,Yes,5,4,10,70
5,50,No,9,7,12,35
5,94,Yes,7,8,13,79
3,46,No,8,7,10,26
8,56,Yes,4,9,17,46
8,57,Yes,5,1,9,51
5,46,Yes,9,9,14,30
8,95,Yes,4,6,14,88
8,59,Yes,6,4,12,55
3,77,Yes,9,6,9,60
2,50,No,6,2,4,26
9,83,Yes,6,3,12,85
2,97,Yes,8,6,8,76
9,55,Yes,6,1,10,53
4,90,No,4,1,5,70
2,94,Yes,5,0,2,64
1,66,Yes,8,0,1,41
4,90,Yes,5,0,4,73
9,50,No,6,5,14,47
9,55,Yes,7,4,13,49
4,62,No,9,9,13,53
9,99,No,8,7,16,95
6,98,Yes,6,4,10,87
1,51,Yes,8,0,1,26
6,98,No,7,7,13,89
9,79,No,4,5,14,73
2,42,Yes,4,7,9,19
6,41,Yes,9,1,7,33
2,99,No,4,9,11,75
4,77,No,7,7,11,59
8,87,No,5,5,13,79
7,91,No,7,0,7,82
9,63,Yes,7,0,9,58
7,68,No,6,9,16,61
1,86,Yes,4,4,5,59
2,85,No,8,6,8,63
6,73,No,9,3,9,60
7,59,Yes,5,9,16,55
3,57,Yes,8,4,7,38
9,53,Yes,6,9,18,49
7,57,Yes,6,2,9,48
6,41,No,5,1,7,24
6,40,Yes,8,1,7,27
1,59,Yes,5,4,5,34
5,73,Yes,5,3,8,59
3,80,No,4,1,4,60
7,80,No,8,4,11,75
3,87,Yes,4,9,12,67
5,50,No,4,8,13,36
7,66,No,9,7,14,60
3,62,Yes,4,8,11,43
2,77,No,7,8,10,52
6,83,Yes,6,7,13,73
8,42,Yes,6,8,16,36
4,51,Yes,7,3,7,37
9,69,No,5,7,16,66
8,70,Yes,8,1,9,64
7,62,No,8,8,15,54
7,40,No,8,8,15,31
3,80,No,4,2,5,59
6,59,No,8,5,11,49
5,93,Yes,8,6,11,80
1,45,Yes,8,2,3,19
3,50,No,6,4,7,27
1,74,Yes,7,0,1,51
4,43,No,9,2,6,25
3,68,No,5,7,10,48
4,98,Yes,7,2,6,82
9,49,No,8,7,16,47
3,90,Yes,5,8,11,70
6,68,No,5,5,11,57
6,77,No,7,6,12,69
7,40,No,7,5,12,32
9,79,No,7,7,16,78
7,47,Yes,9,6,13,41
1,96,No,7,9,10,72
8,77,No,9,0,8,71
5,56,Yes,4,2,7,44
9,58,No,6,2,11,57
5,72,No,9,2,7,57
5,54,No,6,3,8,41
2,84,No,8,0,2,62
3,70,No,4,1,4,48
9,60,No,5,4,13,59
7,42,Yes,7,5,12,34
1,41,No,8,8,9,17
3,74,Yes,5,1,4,54
2,80,No,6,8,10,55
1,98,Yes,5,6,7,73
9,55,Yes,7,8,17,50
8,95,Yes,7,3,11,91
5,84,Yes,9,6,11,73
2,90,No,9,0,2,70
1,98,No,6,7,8,74
7,89,No,7,6,13,86
2,60,Yes,4,6,8,34
1,51,Yes,8,1,2,25
2,67,Yes,6,9,11,47
7,51,Yes,6,8,15,45
7,72,Yes,5,7,14,62
6,59,Yes,6,0,6,49
5,79,Yes,8,0,5,62
3,88,No,4,4,7,65
3,60,Yes,5,1,4,40
9,99,No,8,0,9,97
4,91,No,9,9,13,79
9,93,Yes,6,7,16,93
4,78,Yes,7,3,7,60
2,80,Yes,9,1,3,61
4,88,Yes,7,4,8,73
6,98,No,8,5,11,89
6,81,Yes,4,7,13,71
5,75,No,7,6,11,61
1,61,Yes,8,6,7,39
3,65,No,5,0,3,44
5,46,No,6,2,7,32
6,46,No,4,2,8,35
1,47,No,4,6,7,20
9,65,No,5,1,10,62
3,63,Yes,4,9,12,42
3,63,Yes,8,6,9,43
2,79,Yes,4,8,10,56
8,87,No,4,0,8,79
3,51,Yes,4,1,4,30
6,86,No,8,5,11,73
2,47,No,9,1,3,25
7,93,Yes,6,1,8,84
4,48,No,7,4,8,27
9,42,Yes,9,6,15,41
9,93,No,4,3,12,92
7,60,Yes,5,5,12,53
8,70,No,5,2,10,63
3,87,Yes,8,3,6,67
5,86,Yes,6,3,8,74
2,63,No,4,3,5,37
7,43,No,8,0,7,33
8,59,No,7,3,11,58
9,55,Yes,6,3,12,55
7,49,Yes,6,5,12,40
8,82,No,8,8,16,79
9,65,Yes,9,9,18,68
6,68,Yes,5,5,11,57
2,44,No,9,5,7,20
2,50,Yes,6,6,8,28
4,68,Yes,5,6,10,50
9,84,Yes,6,0,9,80
7,54,No,6,7,14,44
2,45,Yes,6,0,2,19
8,87,No,7,8,16,81
7,54,Yes,5,3,10,46
9,82,Yes,7,8,17,83
8,59,Yes,5,7,15,58
3,73,Yes,7,8,11,53
1,99,Yes,7,5,6,73
2,99,No,7,8,10,79
2,41,Yes,8,3,5,15
4,83,Yes,7,2,6,62
6,55,Yes,9,2,8,46
4,58,Yes,9,7,11,41
9,73,No,6,1,10,68
4,88,Yes,4,5,9,72
6,53,Yes,7,8,14,43
6,63,Yes,4,8,14,51
1,67,Yes,4,7,8,38
8,87,No,6,7,15,80
3,71,No,4,0,3,48
6,76,Yes,4,6,12,63
3,49,Yes,9,0,3,31
2,88,Yes,4,8,10,66
5,84,Yes,5,2,7,69
1,87,Yes,7,0,1,62
9,48,No,7,7,16,49
7,63,No,4,6,13,54
3,75,Yes,6,1,4,57
4,95,Yes,5,6,10,77
6,68,Yes,6,4,10,56
3,99,No,6,6,9,79
7,68,Yes,4,9,16,60
6,97,Yes,8,6,12,88
9,87,No,4,1,10,83
5,62,No,9,1,6,43
4,66,Yes,8,6,10,48
3,70,Yes,5,2,5,50
1,82,Yes,8,3,4,61
3,46,Yes,4,6,9,24
3,88,No,4,1,4,71
7,93,No,6,1,8,81
7,84,Yes,4,8,15,76
1,43,No,9,0,1,17
3,53,Yes,4,2,5,30
8,81,No,7,9,17,78
9,81,Yes,7,3,12,78
7,49,Yes,6,4,11,37
7,98,No,8,2,9,86
8,83,No,8,8,16,77
6,73,No,7,4,10,63
3,65,No,9,6,9,46
1,62,No,5,6,7,38
7,48,Yes,9,8,15,41
1,76,Yes,7,1,2,51
1,47,No,9,2,3,24
9,92,Yes,5,3,12,88
7,53,Yes,8,7,14,50
4,46,Yes,7,0,4,30
6,46,Yes,4,8,14,32
1,48,No,5,4,5,18
7,42,Yes,5,3,10,29
6,53,Yes,5,7,13,41
4,56,Yes,8,8,12,37
7,89,Yes,9,2,9,85
3,83,No,6,3,6,67
1,61,Yes,4,0,1,30
4,85,Yes,7,2,6,69
3,65,Yes,9,9,12,43
1,97,No,5,4,5,72
2,67,No,8,7,9,47
5,84,Yes,5,0,5,69
8,53,Yes,9,0,8,48
1,48,No,7,2,3,20
4,90,Yes,4,8,12,73
4,65,No,5,8,12,49
5,41,Yes,8,0,5,26
7,50,Yes,8,3,10,44
8,56,No,6,7,15,49
6,73,Yes,8,1,7,61
1,58,Yes,6,3,4,28
7,78,Yes,4,6,13,74
3,57,No,7,6,9,33
6,52,No,6,4,10,42
8,44,Yes,5,6,14,39
7,89,Yes,9,5,12,82
6,62,Yes,5,1,7,48
9,97,Yes,7,8,17,95
9,95,No,8,4,13,92
1,63,No,9,1,2,36
1,68,No,5,5,6,37
1,87,Yes,9,9,10,65
8,86,Yes,6,4,12,82
7,47,No,7,1,8,37
3,65,Yes,5,9,12,45
2,54,Yes,8,9,11,34
4,96,No,9,6,10,78
3,40,Yes,8,9,12,18
7,67,No,9,1,8,59
8,88,Yes,5,6,14,82
6,86,Yes,7,5,11,75
3,85,Yes,4,3,6,65
6,53,Yes,5,3,9,40
2,81,Yes,8,5,7,60
7,73,No,4,8,15,67
7,98,No,7,9,16,95
4,70,Yes,8,5,9,56
8,45,Yes,7,5,13,35
4,88,No,9,0,4,73
7,44,No,5,4,11,37
4,70,Yes,7,0,4,53
5,76,No,8,8,13,62
7,54,No,5,9,16,44
3,54,No,8,3,6,36
5,91,Yes,8,1,6,76
3,82,No,4,8,11,60
5,44,No,6,5,10,28
3,67,No,7,9,12,48
7,72,No,7,2,9,62
1,50,Yes,4,1,2,19
9,82,No,9,5,14,80
9,45,No,7,9,18,46
5,62,No,4,5,10,47
9,79,Yes,7,8,17,79
6,41,Yes,7,4,10,27
5,54,Yes,8,8,13,43
3,62,No,4,4,7,43
8,61,No,9,1,9,56
4,48,No,7,0,4,27
3,86,Yes,9,8,11,70
6,79,No,6,9,15,70
8,69,No,4,6,14,61
9,55,Yes,4,2,11,53
6,98,No,4,5,11,87
5,85,No,8,9,14,68
2,86,Yes,4,3,5,61
2,91,Yes,8,8,10,70
9,69,Yes,6,1,10,65
2,84,Yes,5,3,5,61
2,48,Yes,8,0,2,27
3,40,No,7,6,9,22
3,98,Yes,4,3,6,81
4,77,No,5,4,8,60
7,47,No,8,0,7,41
9,98,Yes,9,1,10,98
2,98,Yes,9,3,5,79
4,91,No,7,1,5,77
9,57,No,5,0,9,51
2,66,No,6,9,11,43
1,57,Yes,8,0,1,27
8,71,No,9,5,13,69
9,97,Yes,9,1,10,98
7,88,No,8,2,9,80
8,71,No,9,4,12,68
4,92,No,6,2,6,76
4,87,Yes,9,5,9,72
2,84,Yes,8,6,8,64
8,93,No,4,9,17,87
2,75,No,9,5,7,53
9,75,No,8,1,10,71
4,60,Yes,4,8,12,40
1,85,Yes,9,1,2,58
4,71,Yes,9,5,9,55
3,70,Yes,8,8,11,50
6,76,Yes,7,8,14,64
7,55,No,7,1,8,44
8,85,No,5,8,16,79
2,85,No,7,7,9,65
6,53,Yes,6,6,12,37
6,96,No,5,7,13,85
5,63,Yes,7,9,14,48
7,64,Yes,4,7,14,55
3,85,No,8,0,3,64
4,90,No,7,8,12,74
9,74,Yes,4,5,14,67
4,56,Yes,5,0,4,38
3,85,No,8,0,3,65
2,81,Yes,7,6,8,60
5,84,Yes,5,9,14,72
4,93,Yes,7,1,5,73
8,43,No,5,5,13,34
7,50,Yes,7,4,11,45
6,86,Yes,4,4,10,75
2,54,Yes,6,9,11,28
3,69,Yes,4,5,8,48
9,63,Yes,8,7,16,64
9,41,Yes,7,4,13,42
5,82,Yes,6,7,12,72
3,73,No,6,4,7,52
2,62,No,8,9,11,40
8,70,No,8,5,13,61
6,76,Yes,6,7,13,66
7,52,No,8,1,8,43
1,72,No,8,6,7,49
1,46,Yes,7,2,3,16
2,71,No,4,8,10,46
3,46,Yes,9,9,12,28
1,81,Yes,5,6,7,57
5,77,Yes,6,2,7,62
3,91,No,5,7,10,76
1,83,Yes,6,9,10,56
8,52,No,6,1,9,44
6,63,Yes,4,9,15,49
9,67,Yes,6,7,16,64
3,71,No,6,6,9,52
9,82,Yes,4,4,13,79
9,57,No,8,3,12,52
1,73,Yes,9,9,10,52
3,87,Yes,5,9,12,71
6,73,Yes,6,0,6,59
8,90,Yes,4,3,11,90
4,77,Yes,6,5,9,58
5,40,Yes,4,5,10,25
9,82,Yes,5,1,10,78
6,89,Yes,7,8,14,77
7,81,No,8,0,7,73
7,70,No,7,3,10,61
4,89,No,4,3,7,71
4,99,Yes,6,1,5,82
4,40,No,8,7,11,25
5,90,No,5,1,6,76
5,55,Yes,9,1,6,39
8,97,No,8,1,9,91
9,78,Yes,6,0,9,73
2,54,No,7,4,6,34
7,72,No,4,3,10,64
1,62,No,7,1,2,36
1,92,No,8,0,1,67
4,80,No,9,0,4,63
7,73,Yes,6,1,8,64
2,56,No,4,0,2,29
2,64,Yes,6,8,10,41
1,95,No,6,1,2,70
2,81,Yes,9,2,4,57
7,45,No,8,8,15,36
9,70,No,7,4,13,67
6,44,No,6,7,13,29
2,79,No,6,6,8,58
9,79,No,6,5,14,77
7,69,Yes,4,1,8,60
1,44,No,6,3,4,16
9,51,No,6,8,17,50
2,46,Yes,8,6,8,25
4,84,No,6,2,6,68
9,52,No,9,5,14,52
4,88,No,9,7,11,72
3,43,No,6,7,10,21
1,89,No,9,7,8,63
7,81,Yes,8,7,14,74
6,42,No,4,9,15,24
4,51,Yes,9,5,9,33
6,40,No,9,9,15,29
6,66,No,7,2,8,53
4,82,Yes,8,8,12,68
6,89,No,9,2,8,75
8,52,No,4,3,11,41
3,56,Yes,7,9,12,34
4,47,No,6,0,4,29
1,71,No,8,1,2,44
4,59,Yes,9,5,9,42
9,90,Yes,6,0,9,90
8,56,No,8,8,16,52
4,73,No,7,7,11,55
7,74,No,9,1,8,63
3,74,Yes,4,1,4,56
9,77,Yes,8,7,16,76
4,81,No,4,7,11,62
2,63,No,6,0,2,39
5,93,No,6,4,9,78
2,57,Yes,7,1,3,35
6,89,Yes,7,0,6,74
1,85,Yes,5,2,3,58
6,87,No,5,2,8,72
4,78,No,7,9,13,62
3,72,No,9,8,11,52
2,88,Yes,6,9,11,65
7,62,No,4,0,7,50
9,64,Yes,7,1,10,61
3,76,No,9,8,11,57
6,66,Yes,4,4,10,51
9,40,No,5,8,17,37
2,60,No,4,5,7,40
7,98,Yes,7,9,16,91
5,88,No,6,9,14,77
5,49,Yes,7,2,7,31
7,70,No,8,7,14,61
9,83,No,9,8,17,85
4,64,No,9,1,5,47
9,59,Yes,9,8,17,57
9,96,No,8,3,12,95
4,41,Yes,8,7,11,23
3,94,No,6,4,7,74
2,87,No,9,5,7,67
9,54,Yes,7,3,12,52
2,67,No,8,4,6,50
6,52,No,7,0,6,38
5,89,Yes,5,2,7,76
5,99,Yes,9,3,8,88
4,91,No,8,0,4,73
6,93,Yes,8,2,8,81
5,53,Yes,6,3,8,41
4,89,No,7,8,12,72
9,41,Yes,6,2,11,39
6,73,Yes,6,2,8,62
3,74,No,7,3,6,54
6,76,Yes,5,8,14,68
1,64,Yes,7,8,9,40
5,87,No,5,0,5,72
6,93,No,6,7,13,83
8,54,Yes,5,9,17,49
9,51,No,9,0,9,47
3,48,Yes,5,1,4,27
2,97,Yes,5,9,11,76
4,70,Yes,8,4,8,55
8,53,Yes,8,5,13,49
8,68,No,6,1,9,69
3,92,No,7,9,12,72
4,87,Yes,5,4,8,66
3,82,No,9,2,5,62
2,77,Yes,8,6,8,55
4,81,Yes,7,0,4,65
6,99,No,9,4,10,88
5,47,No,5,2,7,32
3,87,Yes,7,1,4,66
2,42,No,9,2,4,20
9,41,Yes,4,9,18,35
1,55,No,9,3,4,30
9,58,No,9,1,10,54
1,69,Yes,5,1,2,42
7,80,No,7,2,9,67
6,55,No,5,1,7,43
7,70,Yes,5,5,12,60
3,93,Yes,4,1,4,72
3,97,Yes,9,0,3,79
1,67,Yes,7,7,8,41
4,43,Yes,6,9,13,25
2,49,Yes,8,3,5,23
8,90,No,5,1,9,82
3,84,Yes,5,3,6,67
7,57,Yes,5,1,8,48
7,86,Yes,5,4,11,74
9,71,No,8,6,15,70
6,69,Yes,6,5,11,60
1,75,Yes,4,1,2,46
8,48,No,6,3,11,41
1,75,No,8,7,8,50
3,68,Yes,7,6,9,49
5,55,No,4,6,11,40
8,67,No,4,3,11,61
9,60,Yes,7,0,9,56
7,86,Yes,9,6,13,82
9,95,Yes,5,5,14,88
3,41,No,8,7,10,19
5,99,Yes,7,4,9,89
8,98,No,6,7,15,92
1,85,Yes,6,9,10,62
8,74,No,9,7,15,70
7,93,Yes,7,8,15,88
1,67,No,8,0,1,42
6,94,Yes,9,2,8,89
1,75,Yes,9,5,6,51
2,70,Yes,9,3,5,48
5,72,No,4,7,12,59
2,62,No,4,9,11,40
1,99,Yes,5,0,1,71
6,80,No,8,4,10,71
8,56,Yes,6,3,11,50
8,85,No,6,0,8,78
8,88,Yes,5,9,17,84
6,40,No,6,5,11,29
3,81,No,9,9,12,63
1,62,No,5,2,3,34
2,87,No,5,4,6,68
5,66,No,7,5,10,52
5,64,Yes,4,3,8,51
1,71,No,8,9,10,46
1,58,No,8,9,10,32
9,63,No,4,5,14,61
2,96,No,9,6,8,74
7,42,Yes,8,1,8,29
4,99,No,6,6,10,82
7,51,No,6,6,13,43
8,74,Yes,8,1,9,67
5,54,Yes,7,2,7,38
1,56,No,8,2,3,30
4,89,Yes,5,0,4,69
3,71,No,9,0,3,52
5,46,No,5,9,14,33
6,58,Yes,4,5,11,48
2,46,No,9,8,10,23
7,44,Yes,9,8,15,41
3,97,Yes,6,0,3,78
1,79,No,9,6,7,53
3,60,No,7,5,8,39
9,87,Yes,8,3,12,84
6,87,No,5,2,8,70
6,90,Yes,6,8,14,83
4,96,Yes,6,9,13,81
8,86,Yes,7,4,12,82
5,46,Yes,7,7,12,33
7,76,No,7,3,10,64
9,62,No,7,3,12,59
5,50,No,5,5,10,36
5,49,No,7,5,10,36
4,96,No,6,2,6,81
6,60,No,6,1,7,47
2,94,Yes,9,8,10,69
3,98,No,8,1,4,80
1,80,Yes,6,8,9,55
2,72,Yes,6,7,9,54
2,59,Yes,5,9,11,40
8,72,No,9,6,14,70
8,79,Yes,6,4,12,71
2,74,No,4,2,4,47
6,73,Yes,6,1,7,62
5,75,No,8,7,12,59
3,66,No,8,1,4,48
5,58,No,9,7,12,47
5,82,No,9,4,9,72
5,44,No,7,8,13,32
3,68,Yes,5,3,6,47
3,95,No,8,7,10,76
4,49,No,4,6,10,29
7,95,Yes,4,7,14,87
2,98,No,7,4,6,71
4,94,No,5,1,5,75
4,79,No,5,6,10,63
1,52,No,9,2,3,28
8,68,No,6,9,17,64
1,44,Yes,4,9,10,16
8,97,No,4,9,17,89
7,97,Yes,4,9,16,90
9,98,No,4,1,10,91
8,51,Yes,8,2,10,43
5,98,Yes,5,3,8,84
8,52,Yes,6,9,17,47
3,61,No,8,6,9,47
7,79,No,5,9,16,71
4,54,Yes,7,0,4,37
5,52,No,4,5,10,35
9,40,No,6,5,14,38
7,93,Yes,5,7,14,85
4,77,No,7,1,5,58
6,82,Yes,4,1,7,69
7,84,No,7,0,7,74
9,92,Yes,7,2,11,89
4,91,No,8,6,10,80
3,40,No,7,7,10,21
8,50,Yes,8,6,14,45
1,97,Yes,9,8,9,74
9,82,No,8,7,16,77
1,79,Yes,7,7,8,51
2,61,Yes,5,1,3,38
8,74,Yes,7,0,8,69
9,99,Yes,7,5,14,98
7,90,Yes,5,6,13,85
3,83,No,4,5,8,62
7,45,Yes,6,6,13,38
6,67,Yes,9,7,13,57
2,70,Yes,4,1,3,41
3,94,Yes,7,0,3,76
5,47,No,4,9,14,30
4,44,Yes,6,7,11,28
2,81,No,4,7,9,56
4,93,No,6,7,11,77
8,87,Yes,4,9,17,85
5,83,Yes,8,6,11,72
5,56,No,7,1,6,42
3,77,No,6,3,6,56
8,48,No,9,8,16,43
6,49,Yes,7,7,13,38
2,59,No,8,3,5,38
2,53,Yes,4,7,9,30
9,53,No,7,9,18,52
7,65,No,4,5,12,55
9,68,Yes,4,8,17,67
6,88,Yes,7,0,6,78
5,66,No,6,5,10,51
1,64,Yes,6,3,4,39
6,55,Yes,7,2,8,46
6,75,No,6,4,10,67
3,73,Yes,5,9,12,52
3,55,Yes,4,7,10,36
3,72,No,7,9,12,54
3,42,No,9,5,8,25
7,62,Yes,8,0,7,53
2,50,Yes,7,5,7,28
2,87,Yes,7,6,8,64
3,97,No,4,5,8,77
7,57,No,8,2,9,46
3,86,Yes,4,8,11,69
7,80,Yes,9,9,16,74
9,83,Yes,6,9,18,85
4,68,No,7,3,7,49
7,98,No,4,4,11,89
9,89,Yes,9,4,13,88
8,44,Yes,9,2,10,40
8,63,Yes,5,1,9,58
9,68,Yes,7,7,16,63
5,68,No,9,6,11,57
5,99,Yes,6,4,9,87
3,65,Yes,4,0,3,40
5,79,No,4,9,14,67
8,42,Yes,5,0,8,32
5,41,Yes,6,7,12,27
4,64,Yes,9,3,7,47
8,58,Yes,5,3,11,51
7,79,Yes,9,8,15,72
6,41,Yes,9,1,7,31
5,58,No,7,4,9,42
5,40,Yes,8,5,10,28
2,66,No,9,5,7,45
4,93,No,4,9,13,75
8,84,No,9,2,10,81
8,94,No,5,9,17,88
1,91,Yes,9,5,6,67
2,88,Yes,4,9,11,62
5,74,Yes,4,9,14,59
9,80,Yes,5,4,13,75
7,44,No,4,7,14,30
5,77,No,6,3,8,62
1,43,No,6,9,10,17
6,56,Yes,8,9,15,47
8,92,No,6,2,10,87
7,60,Yes,5,5,12,51
2,92,No,9,9,11,72
5,87,Yes,6,8,13,76
4,70,No,8,7,11,56
9,87,No,7,9,18,86
1,61,Yes,7,7,8,37
6,50,No,5,2,8,35
3,73,No,8,0,3,54
9,88,Yes,6,2,11,83
5,54,No,8,2,7,40
6,89,No,4,5,11,78
9,49,No,8,2,11,47
9,77,No,6,1,10,68
8,71,Yes,5,8,16,67
9,92,Yes,4,5,14,92
4,87,No,8,4,8,67
6,70,Yes,7,2,8,59
5,76,No,6,6,11,61
5,83,Yes,5,6,11,69
4,67,No,9,3,7,53
2,70,No,6,9,11,48
6,45,Yes,8,1,7,32
9,53,No,5,1,10,47
1,97,No,7,7,8,71
7,62,No,4,3,10,48
6,55,No,8,6,12,43
3,64,Yes,5,2,5,44
1,78,Yes,4,8,9,53
4,41,Yes,5,9,13,24
9,77,Yes,9,8,17,76
2,80,No,8,6,8,58
3,78,No,5,6,9,59
2,73,No,7,0,2,51
2,90,No,5,9,11,68
8,79,Yes,8,7,15,73
3,82,Yes,5,1,4,60
7,64,Yes,4,7,14,56
8,75,No,4,1,9,66
3,55,No,9,0,3,34
2,96,No,6,7,9,75
8,57,No,9,3,11,53
3,52,Yes,6,9,12,31
7,98,Yes,7,5,12,88
1,76,Yes,4,9,10,48
6,66,No,6,9,15,56
9,73,Yes,5,0,9,67
3,50,No,7,8,11,29
7,40,Yes,8,6,13,30
6,52,Yes,6,4,10,40
8,69,No,9,5,13,64
3,44,No,6,2,5,23
3,57,No,9,8,11,39
4,53,Yes,9,1,5,33
3,52,Yes,4,9,12,33
9,71,Yes,7,0,9,68
4,46,Yes,9,0,4,32
6,47,No,4,9,15,33
8,89,Yes,4,1,9,83
8,46,No,9,5,13,41
5,91,Yes,7,5,10,76
5,88,No,5,8,13,76
6,55,No,6,9,15,45
7,82,Yes,4,3,10,72
7,70,Yes,6,7,14,60
4,90,No,7,3,7,75
6,66,Yes,5,2,8,55
7,99,No,8,3,10,91
5,72,Yes,5,0,5,56
5,92,Yes,7,8,13,77
2,68,Yes,5,4,6,47
7,47,Yes,8,6,13,37
6,72,Yes,4,2,8,61
1,80,No,5,4,5,58
4,58,Yes,9,9,13,42
3,60,No,9,3,6,40
3,80,No,7,6,9,59
7,60,No,5,4,11,53
4,64,Yes,8,1,5,47
8,81,No,7,2,10,72
9,95,No,5,7,16,90
3,62,No,7,2,5,43
5,50,No,9,6,11,35
4,72,No,8,4,8,52
6,59,No,4,6,12,47
4,64,Yes,8,9,13,50
8,65,No,4,8,16,57
3,79,No,6,6,9,58
5,91,Yes,9,5,10,78
1,51,No,9,0,1,25
6,71,Yes,9,3,9,64
5,72,Yes,8,7,12,61
8,49,No,4,0,8,42
9,43,No,6,5,14,39
8,54,Yes,6,1,9,46
8,90,Yes,6,8,16,88
3,45,Yes,7,7,10,26
4,66,Yes,8,8,12,49
4,44,No,8,8,12,34
5,44,Yes,9,1,6,31
9,57,Yes,8,1,10,52
9,67,Yes,8,8,17,68
1,74,No,7,1,2,50
8,98,Yes,8,3,11,93
1,61,Yes,4,1,2,32
2,73,No,6,0,2,48
7,43,No,7,9,16,36
8,57,Yes,7,6,14,54
1,80,Yes,9,4,5,55
3,90,Yes,8,2,5,74
7,65,No,6,7,14,53
9,81,No,4,4,13,76
8,61,Yes,6,0,8,54
8,86,Yes,5,8,16,80
9,72,Yes,6,4,13,68
3,82,No,4,2,5,63
8,53,Yes,4,5,13,46
1,70,Yes,4,7,8,45
8,49,No,7,1,9,43
7,90,Yes,7,2,9,83
8,63,No,5,6,14,56
1,60,No,6,1,2,29
6,87,Yes,8,4,10,79
7,47,No,9,8,15,40
5,71,No,5,6,11,55
5,70,Yes,8,2,7,55
7,73,No,8,1,8,65
3,62,No,5,9,12,41
6,64,Yes,6,8,14,53
7,46,Yes,9,8,15,41
1,58,Yes,8,8,9,34
2,46,Yes,7,9,11,23
4,86,Yes,7,2,6,70
8,47,No,5,0,8,38
6,53,No,9,8,14,45
1,40,No,9,6,7,14
5,52,No,8,1,6,37
7,42,No,5,5,12,33
6,92,Yes,9,8,14,81
9,67,Yes,9,7,16,68
8,77,Yes,7,5,13,76
4,90,Yes,5,5,9,74
5,54,No,8,7,12,41
7,75,Yes,8,8,15,70
8,92,Yes,7,7,15,89
5,42,No,4,0,5,25
9,43,No,4,1,10,36
4,44,Yes,9,5,9,27
4,89,No,6,7,11,71
8,65,No,7,3,11,56
1,64,Yes,6,3,4,41
8,49,No,9,1,9,41
5,47,Yes,7,9,14,34
1,51,No,8,0,1,23
4,93,No,7,9,13,78
2,97,No,5,8,10,76
4,98,No,6,6,10,78
8,42,Yes,7,8,16,38
5,66,No,6,1,6,48
1,89,Yes,9,9,10,65
7,62,Yes,7,4,11,59
1,79,No,4,1,2,52
9,97,No,6,9,18,97
3,72,Yes,8,6,9,54
3,53,No,8,8,11,34
6,93,No,7,2,8,80
6,62,Yes,8,0,6,54
6,70,No,8,3,9,63
1,52,Yes,6,3,4,26
5,96,No,7,5,10,85
6,51,No,6,4,10,40
8,74,No,7,4,12,68
1,57,No,8,8,9,32
5,60,No,7,0,5,44
3,84,No,9,7,10,70
2,86,Yes,7,7,9,66
8,81,Yes,5,7,15,76
7,40,No,7,2,9,29
7,77,No,5,9,16,70
5,80,Yes,6,7,12,64
9,81,Yes,5,1,10,76
5,86,Yes,6,7,12,72
2,48,No,7,7,9,24
3,62,No,6,2,5,40
4,53,No,8,3,7,37
5,50,Yes,9,8,13,42
3,46,Yes,7,8,11,28
7,70,No,5,9,16,61
5,63,Yes,9,8,13,53
5,65,No,4,9,14,50
6,69,No,9,5,11,55
7,73,Yes,7,0,7,67
8,85,No,9,7,15,79
9,77,Yes,9,8,17,77
4,44,Yes,8,7,11,26
5,44,No,6,0,5,26
5,58,No,9,5,10,44
8,90,Yes,5,8,16,80
9,77,No,5,8,17,73
7,67,Yes,8,6,13,61
5,65,No,9,6,11,53
3,81,Yes,9,3,6,59
1,62,Yes,8,6,7,40
9,85,No,7,9,18,88
5,88,No,4,4,9,76
9,69,Yes,4,9,18,65
4,42,Yes,6,4,8,23
5,67,Yes,5,0,5,50
4,72,Yes,7,1,5,59
2,81,No,5,8,10,57
1,42,No,7,1,2,14
8,44,No,8,9,17,41
4,96,Yes,6,1,5,81
5,58,No,8,8,13,47
6,81,Yes,5,2,8,67
8,97,Yes,6,1,9,92
8,96,No,9,6,14,95
7,87,No,7,8,15,79
4,40,Yes,7,5,9,24
6,77,Yes,6,6,12,67
4,48,No,8,2,6,30
7,99,Yes,6,2,9,91
1,44,No,8,7,8,21
5,98,No,6,6,11,87
4,85,Yes,8,4,8,69
7,81,Yes,4,5,12,72
9,73,Yes,6,8,17,70
5,76,Yes,8,2,7,66
4,72,Yes,9,2,6,55
9,64,No,5,5,14,60
5,81,No,5,7,12,67
9,68,No,6,4,13,65
8,97,No,6,0,8,87
4,64,Yes,7,2,6,48
7,93,No,8,7,14,87
5,98,Yes,6,3,8,84
4,48,Yes,5,8,12,32
5,42,Yes,5,5,10,27
5,54,Yes,5,9,14,37
9,43,Yes,8,3,12,43
9,84,No,4,3,12,77
6,77,Yes,6,9,15,65
4,59,Yes,4,4,8,43
2,88,No,8,6,8,64
3,62,No,9,6,9,43
2,76,No,6,9,11,57
5,86,Yes,7,6,11,73
6,47,Yes,6,4,10,32
5,96,Yes,6,8,13,85
2,76,Yes,6,1,3,54
5,95,No,6,7,12,81
9,84,No,9,9,18,79
4,72,No,6,7,11,58
2,72,No,8,2,4,53
3,46,No,6,4,7,25
3,61,No,9,7,10,41
9,44,Yes,8,9,18,44
4,85,Yes,6,8,12,70
1,54,No,6,6,7,29
1,60,No,8,3,4,34
7,64,No,6,3,10,56
7,56,No,9,2,9,49
2,95,Yes,5,7,9,78
9,89,Yes,6,5,14,88
9,46,Yes,7,9,18,45
5,93,No,8,5,10,77
3,97,No,9,9,12,76
3,89,No,6,9,12,70
3,99,Yes,6,8,11,80
6,58,Yes,8,2,8,45
4,91,Yes,4,3,7,71
8,46,No,9,2,10,42
5,79,Yes,9,2,7,65
1,84,Yes,5,0,1,56
9,98,No,5,9,18,93
1,89,Yes,6,5,6,62
6,63,No,8,8,14,52
1,50,No,7,4,5,24
3,80,No,6,9,12,61
5,94,Yes,5,1,6,78
7,40,Yes,6,9,16,28
8,93,No,8,3,11,86
9,71,Yes,9,5,14,69
6,79,No,9,6,12,71
9,92,Yes,9,6,15,91
8,83,No,9,3,11,79
9,41,No,7,9,18,41
4,54,Yes,4,9,13,36
9,60,No,7,4,13,57
7,63,No,6,3,10,54
5,89,No,5,9,14,75
5,56,No,8,5,10,40
1,86,No,6,6,7,61
2,91,Yes,4,1,3,67
3,91,Yes,8,9,12,72
8,48,No,8,2,10,42
6,74,Yes,8,7,13,60
5,59,No,6,6,11,41
1,58,No,4,0,1,32
9,57,No,6,3,12,53
3,59,No,8,4,7,42
3,69,No,8,2,5,49
2,79,Yes,5,3,5,56
4,40,Yes,7,9,13,24
2,63,Yes,6,9,11,39
9,63,Yes,4,9,18,61
7,86,Yes,8,6,13,78
8,58,Yes,6,7,15,53
3,69,No,7,8,11,48
6,65,Yes,6,1,7,54
6,81,No,7,3,9,70
1,83,No,6,0,1,59
6,99,Yes,5,2,8,89
3,77,Yes,6,7,10,58
3,68,No,9,6,9,52
3,52,No,5,7,10,32
8,43,No,7,5,13,32
5,84,No,8,4,9,69
4,56,No,8,9,13,40
9,72,Yes,6,8,17,73
9,44,Yes,4,4,13,39
1,67,No,6,8,9,40
2,63,No,5,3,5,35
8,56,No,5,4,12,52
5,89,No,7,0,5,77
7,78,No,6,5,12,67
1,87,No,7,2,3,58
5,79,No,4,9,14,66
3,83,No,8,1,4,66
2,85,Yes,8,5,7,62
2,90,No,6,0,2,66
9,50,No,7,8,17,49
4,51,Yes,7,4,8,32
4,52,No,4,6,10,32
7,47,No,7,9,16,38
2,40,No,9,8,10,16
3,48,No,9,8,11,35
3,67,Yes,5,6,9,49
6,41,No,9,3,9,29
3,53,No,9,3,6,34
5,52,No,5,6,11,33
4,87,Yes,9,7,11,73
3,41,No,9,6,9,23
8,43,No,5,9,17,35
3,51,Yes,6,3,6,30
6,87,Yes,5,3,9,73
7,49,Yes,5,7,14,43
7,42,Yes,9,8,15,38
2,43,No,8,6,8,21
3,45,Yes,9,2,5,26
4,62,Yes,6,9,13,43
7,44,Yes,5,0,7,32
2,89,No,4,4,6,64
3,42,Yes,5,5,8,20
7,49,No,6,8,15,41
7,82,No,7,4,11,70
3,58,Yes,9,0,3,36
1,53,No,8,3,4,26
3,60,Yes,8,1,4,37
5,99,Yes,9,3,8,89
7,82,No,9,6,13,77
4,67,No,6,8,12,47
1,60,No,5,2,3,33
6,75,No,4,2,8,61
2,63,Yes,5,3,5,39
3,93,No,5,6,9,74
4,77,No,4,5,9,54
6,56,No,8,4,10,47
6,61,No,5,3,9,49
7,58,Yes,7,7,14,53
5,84,Yes,7,3,8,66
7,93,No,6,2,9,84
2,49,No,6,6,8,27
1,50,Yes,4,1,2,23
8,77,Yes,4,3,11,72
1,41,Yes,6,7,8,16
2,72,Yes,9,3,5,47
6,82,No,5,9,15,73
1,70,No,9,6,7,45
3,87,Yes,8,1,4,68
7,74,Yes,7,4,11,69
8,76,No,4,3,11,69
4,86,No,6,8,12,69
3,86,Yes,7,6,9,65
1,75,No,9,8,9,48
9,62,Yes,4,9,18,57
6,75,No,4,6,12,62
6,79,No,5,1,7,70
9,78,Yes,4,1,10,73
1,65,No,8,1,2,39
6,64,Yes,4,4,10,53
5,56,No,8,0,5,40
6,54,Yes,9,6,12,47
8,76,Yes,5,1,9,68
5,84,Yes,8,3,8,73
2,43,No,9,8,10,23
2,61,Yes,7,7,9,39
5,56,Yes,4,9,14,40
3,61,No,6,1,4,42
3,56,No,6,3,6,35
8,53,Yes,8,3,11,47
7,53,Yes,5,1,8,46
1,56,No,8,1,2,26
5,47,No,9,4,9,36
9,73,No,9,3,12,75
4,65,Yes,8,7,11,48
1,84,No,8,3,4,57
8,69,Yes,7,7,15,62
5,61,Yes,9,4,9,50
2,55,Yes,7,0,2,30
1,69,No,8,8,9,44
3,55,No,5,7,10,36
9,77,No,4,0,9,69
1,93,Yes,9,2,3,66
4,63,Yes,6,2,6,46
8,75,No,7,4,12,68
8,74,No,9,6,14,68
8,45,Yes,4,0,8,37
8,43,Yes,7,0,8,36
4,57,Yes,9,9,13,40
8,45,Yes,7,5,13,40
9,65,No,7,4,13,60
7,76,Yes,8,2,9,70
2,66,Yes,8,2,4,43
9,80,No,7,3,12,81
8,50,No,7,9,17,42
5,77,No,6,1,6,60
3,55,No,4,8,11,36
7,58,Yes,4,3,10,46
2,82,Yes,5,9,11,60
3,92,Yes,5,2,5,67
9,54,Yes,5,9,18,49
4,65,Yes,8,6,10,47
4,95,No,8,8,12,79
3,80,No,6,1,4,61
5,95,Yes,8,5,10,82
3,70,No,5,4,7,48
9,58,Yes,9,0,9,54
3,96,Yes,7,6,9,75
2,90,Yes,5,0,2,68
5,63,Yes,6,9,14,50
6,97,Yes,7,8,14,87
1,48,No,8,3,4,25
6,62,No,7,7,13,45
3,43,Yes,9,0,3,25
4,49,Yes,6,4,8,28
6,48,No,8,2,8,36
8,58,Yes,4,3,11,53
9,54,Yes,5,3,12,47
6,90,Yes,9,7,13,84
7,73,No,9,9,16,66
5,81,Yes,5,9,14,66
9,58,Yes,6,2,11,55
4,88,No,6,0,4,71
6,91,Yes,9,4,10,86
5,95,Yes,5,1,6,80
1,60,No,7,5,6,36
5,73,No,4,3,8,57
5,90,Yes,4,8,13,77
9,56,No,6,6,15,52
1,57,Yes,6,1,2,29
5,56,Yes,7,6,11,43
7,41,No,6,9,16,30
6,90,Yes,4,7,13,74
6,40,No,5,2,8,27
7,82,No,9,2,9,72
6,96,No,4,1,7,82
5,49,Yes,7,0,5,31
5,76,No,5,2,7,62
9,87,Yes,5,9,18,79
8,95,No,9,6,14,92
4,44,No,4,8,12,27
4,95,Yes,5,8,12,79
5,94,Yes,5,5,10,82
3,51,No,6,5,8,28
8,75,Yes,5,4,12,73
7,70,Yes,7,1,8,59
5,94,No,5,6,11,81
3,77,No,6,0,3,59
5,90,Yes,8,5,10,77
3,48,No,8,3,6,26
5,83,No,7,2,7,70
1,65,No,9,0,1,38
6,54,Yes,9,5,11,42
4,55,Yes,7,6,10,40
4,52,Yes,5,0,4,35
8,64,No,5,0,8,56
2,69,Yes,8,6,8,48
4,92,No,8,5,9,76
2,95,No,4,6,8,71
1,46,No,8,7,8,20
3,96,No,8,7,10,75
8,94,Yes,7,8,16,89
6,91,No,4,8,14,79
7,43,No,9,6,13,40
2,82,Yes,4,8,10,57
6,79,No,5,5,11,66
8,77,Yes,5,8,16,69
8,96,Yes,4,1,9,85
4,69,Yes,4,1,5,53
6,49,No,5,5,11,37
5,69,Yes,7,2,7,58
9,78,No,7,1,10,71
8,46,Yes,7,7,15,42
2,75,Yes,7,6,8,58
7,74,Yes,5,7,14,68
7,63,Yes,6,5,12,56
1,78,No,8,8,9,52
1,75,No,8,8,9,54
4,84,Yes,8,1,5,66
5,59,Yes,8,9,14,48
4,88,Yes,5,4,8,69
7,71,No,6,8,15,62
3,98,Yes,5,2,5,80
7,78,Yes,6,4,11,71
8,88,No,5,7,15,82
6,65,Yes,4,1,7,56
6,65,Yes,6,5,11,53
8,75,Yes,8,3,11,72
8,82,Yes,6,5,13,76
7,74,No,9,2,9,63
6,82,No,7,5,11,70
6,74,No,6,6,12,59
6,51,Yes,9,9,15,42
8,72,Yes,7,2,10,67
1,75,No,9,4,5,52
5,53,Yes,7,7,12,40
3,72,Yes,4,1,4,50
8,85,No,6,6,14,79
6,84,No,9,0,6,75
2,84,Yes,4,6,8,63
7,63,No,8,0,7,56
7,54,Yes,6,3,10,40
5,70,No,5,3,8,57
8,56,No,5,4,12,50
5,51,Yes,5,1,6,39
1,61,Yes,9,5,6,36
9,62,No,9,5,14,59
4,65,Yes,7,7,11,49
2,53,Yes,5,9,11,26
4,51,Yes,8,0,4,28
9,89,No,9,3,12,88
2,43,Yes,6,1,3,17
4,98,Yes,9,7,11,81
2,85,No,6,3,5,63
5,90,No,9,7,12,74
3,52,No,7,1,4,32
2,96,No,7,3,5,72
9,94,Yes,7,8,17,91
5,57,Yes,8,4,9,44
5,82,No,9,5,10,66
1,67,No,6,9,10,45
6,77,Yes,9,8,14,68
7,80,Yes,4,8,15,71
1,83,No,7,6,7,59
9,58,Yes,5,1,10,56
8,85,Yes,4,6,14,78
8,86,No,4,8,16,81
7,82,No,7,1,8,74
5,77,No,5,6,11,65
3,85,No,7,6,9,65
9,42,Yes,7,2,11,40
7,58,No,5,5,12,49
8,59,Yes,4,7,15,54
6,64,Yes,4,9,15,48
5,50,Yes,9,7,12,40
8,95,No,5,2,10,90
3,56,Yes,4,5,8,36
7,99,No,8,1,8,89
2,98,No,7,1,3,78
3,88,No,8,7,10,69
2,94,Yes,8,9,11,75
5,74,No,9,4,9,58
7,53,No,9,4,11,44
1,98,Yes,9,3,4,74
9,78,No,8,9,18,75
1,96,Yes,6,3,4,69
1,58,Yes,6,7,8,34
8,42,No,8,2,10,38
6,73,No,7,2,8,58
6,97,No,8,7,13,92
9,88,No,8,2,11,84
4,80,Yes,9,1,5,62
8,61,No,9,4,12,59
4,77,No,9,2,6,62
2,95,Yes,6,5,7,75
8,66,No,8,6,14,59
7,60,No,7,2,9,52
4,80,No,7,8,12,69
9,70,No,9,9,18,67
9,66,No,9,0,9,65
8,76,Yes,8,6,14,70
1,41,No,7,3,4,12
7,93,Yes,8,6,13,86
5,86,Yes,6,8,13,73
7,48,Yes,8,8,15,41
9,58,Yes,9,0,9,55
2,81,No,4,9,11,62
4,75,No,6,3,7,61
4,49,Yes,7,6,10,33
2,98,No,7,9,11,77
3,79,No,9,5,8,63
8,93,Yes,9,8,16,91
9,84,No,6,6,15,82
6,78,Yes,9,2,8,72
2,46,Yes,4,6,8,20
2,43,No,6,9,11,20
7,54,No,9,4,11,46
8,51,No,5,1,9,44
8,87,Yes,4,9,17,79
6,45,Yes,6,2,8,34
8,99,No,5,5,13,92
1,48,Yes,8,5,6,25
9,74,No,4,6,15,69
1,47,No,8,5,6,20
3,46,No,5,8,11,27
9,43,No,7,4,13,40
5,97,Yes,7,4,9,83
9,52,No,9,7,16,50
9,58,Yes,7,7,16,55
6,46,Yes,8,0,6,39
1,49,Yes,4,2,3,23
7,64,Yes,8,5,12,58
6,83,Yes,8,5,11,74
9,97,Yes,7,0,9,95
7,74,No,8,1,8,64